I,GEN,LogL,RateVector,State,N,F,Total
0,0,-360.941,Non-functional,N,24,5,29
0,0,-360.941,Functional,F,9,36,45
1,100,-359.312,Non-functional,N,24,5,29
1,100,-359.312,Functional,F,9,36,45
2,200,-358.943,Non-functional,N,24,5,29
2,200,-358.943,Functional,F,9,36,45
3,300,-359.777,Non-functional,N,24,5,29
3,300,-359.777,Functional,F,9,36,45
4,400,-361.162,Non-functional,N,24,5,29
4,400,-361.162,Functional,F,9,36,45
5,500,-358.749,Non-functional,N,24,5,29
5,500,-358.749,Functional,F,9,36,45
6,600,-452.569,Non-functional,N,21,4,25
6,600,-452.569,Functional,F,11,45,56
7,700,-452.226,Non-functional,N,21,4,25
7,700,-452.226,Functional,F,11,45,56
8,800,-449.962,Non-functional,N,21,4,25
8,800,-449.962,Functional,F,11,45,56
9,900,-449.734,Non-functional,N,21,4,25
9,900,-449.734,Functional,F,11,45,56
10,1000,-449.411,Non-functional,N,21,4,25
10,1000,-449.411,Functional,F,11,45,56
11,1100,-383.056,Non-functional,N,16,4,20
11,1100,-383.056,Functional,F,10,46,56
12,1200,-384.374,Non-functional,N,16,4,20
12,1200,-384.374,Functional,F,10,46,56
13,1300,-384.896,Non-functional,N,16,4,20
13,1300,-384.896,Functional,F,10,46,56
14,1400,-384.734,Non-functional,N,16,4,20
14,1400,-384.734,Functional,F,10,46,56
15,1500,-385.131,Non-functional,N,16,4,20
15,1500,-385.131,Functional,F,10,46,56
16,1600,-430.913,Non-functional,N,21,7,28
16,1600,-430.913,Functional,F,8,40,48
17,1700,-431.451,Non-functional,N,21,7,28
17,1700,-431.451,Functional,F,8,40,48
18,1800,-430.126,Non-functional,N,21,7,28
18,1800,-430.126,Functional,F,8,40,48
19,1900,-429.834,Non-functional,N,21,7,28
19,1900,-429.834,Functional,F,8,40,48
20,2000,-430.037,Non-functional,N,21,7,28
20,2000,-430.037,Functional,F,8,40,48
21,2100,-343.887,Non-functional,N,16,3,19
21,2100,-343.887,Functional,F,11,36,47
22,2200,-345.524,Non-functional,N,16,3,19
22,2200,-345.524,Functional,F,11,36,47
23,2300,-344.479,Non-functional,N,16,3,19
23,2300,-344.479,Functional,F,11,36,47
24,2400,-344.36,Non-functional,N,16,3,19
24,2400,-344.36,Functional,F,11,36,47
25,2500,-344.455,Non-functional,N,16,3,19
25,2500,-344.455,Functional,F,11,36,47
26,2600,-412.118,Non-functional,N,23,3,26
26,2600,-412.118,Functional,F,11,41,52
27,2700,-412.468,Non-functional,N,23,3,26
27,2700,-412.468,Functional,F,11,41,52
28,2800,-411.585,Non-functional,N,23,3,26
28,2800,-411.585,Functional,F,11,41,52
29,2900,-411.768,Non-functional,N,23,3,26
29,2900,-411.768,Functional,F,11,41,52
30,3000,-412.347,Non-functional,N,23,3,26
30,3000,-412.347,Functional,F,11,41,52
31,3100,-427.002,Non-functional,N,27,7,34
31,3100,-427.002,Functional,F,7,35,42
32,3200,-425.674,Non-functional,N,27,7,34
32,3200,-425.674,Functional,F,7,35,42
33,3300,-426.813,Non-functional,N,27,7,34
33,3300,-426.813,Functional,F,7,35,42
34,3400,-426.298,Non-functional,N,27,7,34
34,3400,-426.298,Functional,F,7,35,42
35,3500,-425.275,Non-functional,N,27,7,34
35,3500,-425.275,Functional,F,7,35,42
36,3600,-412.824,Non-functional,N,19,1,20
36,3600,-412.824,Functional,F,13,39,52
37,3700,-412.498,Non-functional,N,19,1,20
37,3700,-412.498,Functional,F,13,39,52
38,3800,-411.656,Non-functional,N,19,1,20
38,3800,-411.656,Functional,F,13,39,52
39,3900,-412.601,Non-functional,N,19,1,20
39,3900,-412.601,Functional,F,13,39,52
40,4000,-413.651,Non-functional,N,19,1,20
40,4000,-413.651,Functional,F,13,39,52
41,4100,-446.14,Non-functional,N,34,5,39
41,4100,-446.14,Functional,F,9,39,48
42,4200,-448.052,Non-functional,N,34,5,39
42,4200,-448.052,Functional,F,9,39,48
43,4300,-448.079,Non-functional,N,34,5,39
43,4300,-448.079,Functional,F,9,39,48
44,4400,-446.238,Non-functional,N,34,5,39
44,4400,-446.238,Functional,F,9,39,48
45,4500,-446.075,Non-functional,N,34,5,39
45,4500,-446.075,Functional,F,9,39,48
46,4600,-437.54,Non-functional,N,20,3,23
46,4600,-437.54,Functional,F,11,45,56
47,4700,-437.146,Non-functional,N,20,3,23
47,4700,-437.146,Functional,F,11,45,56
48,4800,-437.072,Non-functional,N,20,3,23
48,4800,-437.072,Functional,F,11,45,56
49,4900,-437.255,Non-functional,N,20,3,23
49,4900,-437.255,Functional,F,11,45,56
50,5000,-437.565,Non-functional,N,20,3,23
50,5000,-437.565,Functional,F,11,45,56
51,5100,-422.613,Non-functional,N,24,1,25
51,5100,-422.613,Functional,F,13,43,56
52,5200,-423.73,Non-functional,N,24,1,25
52,5200,-423.73,Functional,F,13,43,56
53,5300,-422.169,Non-functional,N,24,1,25
53,5300,-422.169,Functional,F,13,43,56
54,5400,-422.371,Non-functional,N,24,1,25
54,5400,-422.371,Functional,F,13,43,56
55,5500,-422.556,Non-functional,N,24,1,25
55,5500,-422.556,Functional,F,13,43,56
56,5600,-328.004,Non-functional,N,23,2,25
56,5600,-328.004,Functional,F,12,31,43
57,5700,-327.9,Non-functional,N,23,2,25
57,5700,-327.9,Functional,F,12,31,43
58,5800,-327.505,Non-functional,N,23,2,25
58,5800,-327.505,Functional,F,12,31,43
59,5900,-329.314,Non-functional,N,23,2,25
59,5900,-329.314,Functional,F,12,31,43
60,6000,-331.797,Non-functional,N,23,2,25
60,6000,-331.797,Functional,F,12,31,43
61,6100,-419.812,Non-functional,N,28,6,34
61,6100,-419.812,Functional,F,8,44,52
62,6200,-420.194,Non-functional,N,28,6,34
62,6200,-420.194,Functional,F,8,44,52
63,6300,-420.325,Non-functional,N,28,6,34
63,6300,-420.325,Functional,F,8,44,52
64,6400,-420.205,Non-functional,N,28,6,34
64,6400,-420.205,Functional,F,8,44,52
65,6500,-420.578,Non-functional,N,28,6,34
65,6500,-420.578,Functional,F,8,44,52
66,6600,-416.725,Non-functional,N,22,6,28
66,6600,-416.725,Functional,F,8,43,51
67,6700,-417.185,Non-functional,N,22,6,28
67,6700,-417.185,Functional,F,8,43,51
68,6800,-416.211,Non-functional,N,22,6,28
68,6800,-416.211,Functional,F,8,43,51
69,6900,-417.403,Non-functional,N,22,6,28
69,6900,-417.403,Functional,F,8,43,51
70,7000,-416.413,Non-functional,N,22,6,28
70,7000,-416.413,Functional,F,8,43,51
71,7100,-385.292,Non-functional,N,20,6,26
71,7100,-385.292,Functional,F,8,42,50
72,7200,-386.166,Non-functional,N,20,6,26
72,7200,-386.166,Functional,F,8,42,50
73,7300,-385.802,Non-functional,N,20,6,26
73,7300,-385.802,Functional,F,8,42,50
74,7400,-384.654,Non-functional,N,20,6,26
74,7400,-384.654,Functional,F,8,42,50
75,7500,-385.367,Non-functional,N,20,6,26
75,7500,-385.367,Functional,F,8,42,50
76,7600,-428.84,Non-functional,N,25,7,32
76,7600,-428.84,Functional,F,7,37,44
77,7700,-428.382,Non-functional,N,25,7,32
77,7700,-428.382,Functional,F,7,37,44
78,7800,-426.504,Non-functional,N,25,7,32
78,7800,-426.504,Functional,F,7,37,44
79,7900,-426.645,Non-functional,N,25,7,32
79,7900,-426.645,Functional,F,7,37,44
80,8000,-426.653,Non-functional,N,25,7,32
80,8000,-426.653,Functional,F,7,37,44
81,8100,-363.539,Non-functional,N,22,4,26
81,8100,-363.539,Functional,F,10,41,51
82,8200,-364.995,Non-functional,N,22,4,26
82,8200,-364.995,Functional,F,10,41,51
83,8300,-364.547,Non-functional,N,22,4,26
83,8300,-364.547,Functional,F,10,41,51
84,8400,-363.454,Non-functional,N,22,4,26
84,8400,-363.454,Functional,F,10,41,51
85,8500,-363.157,Non-functional,N,22,4,26
85,8500,-363.157,Functional,F,10,41,51
86,8600,-448.707,Non-functional,N,17,5,22
86,8600,-448.707,Functional,F,10,43,53
87,8700,-448.188,Non-functional,N,17,5,22
87,8700,-448.188,Functional,F,10,43,53
88,8800,-448.276,Non-functional,N,17,5,22
88,8800,-448.276,Functional,F,10,43,53
89,8900,-447.843,Non-functional,N,17,5,22
89,8900,-447.843,Functional,F,10,43,53
90,9000,-447.673,Non-functional,N,17,5,22
90,9000,-447.673,Functional,F,10,43,53
91,9100,-399.322,Non-functional,N,17,5,22
91,9100,-399.322,Functional,F,12,34,46
92,9200,-400.052,Non-functional,N,17,5,22
92,9200,-400.052,Functional,F,12,34,46
93,9300,-399.691,Non-functional,N,17,5,22
93,9300,-399.691,Functional,F,12,34,46
94,9400,-400.488,Non-functional,N,17,5,22
94,9400,-400.488,Functional,F,12,34,46
95,9500,-401.524,Non-functional,N,17,5,22
95,9500,-401.524,Functional,F,12,34,46
96,9600,-397.192,Non-functional,N,19,0,19
96,9600,-397.192,Functional,F,14,48,62
97,9700,-397.564,Non-functional,N,19,0,19
97,9700,-397.564,Functional,F,14,48,62
98,9800,-398.757,Non-functional,N,19,0,19
98,9800,-398.757,Functional,F,14,48,62
99,9900,-398.205,Non-functional,N,19,0,19
99,9900,-398.205,Functional,F,14,48,62
100,10000,-397.658,Non-functional,N,19,0,19
100,10000,-397.658,Functional,F,14,48,62
101,10100,-428.945,Non-functional,N,17,0,17
101,10100,-428.945,Functional,F,14,52,66
102,10200,-427.959,Non-functional,N,17,0,17
102,10200,-427.959,Functional,F,14,52,66
103,10300,-427.259,Non-functional,N,17,0,17
103,10300,-427.259,Functional,F,14,52,66
104,10400,-427.335,Non-functional,N,17,0,17
104,10400,-427.335,Functional,F,14,52,66
105,10500,-428.304,Non-functional,N,17,0,17
105,10500,-428.304,Functional,F,14,52,66
106,10600,-333.041,Non-functional,N,13,0,13
106,10600,-333.041,Functional,F,14,37,51
107,10700,-333.3,Non-functional,N,13,0,13
107,10700,-333.3,Functional,F,14,37,51
108,10800,-333.473,Non-functional,N,13,0,13
108,10800,-333.473,Functional,F,14,37,51
109,10900,-332.687,Non-functional,N,13,0,13
109,10900,-332.687,Functional,F,14,37,51
110,11000,-332.571,Non-functional,N,13,0,13
110,11000,-332.571,Functional,F,14,37,51
111,11100,-384.604,Non-functional,N,19,0,19
111,11100,-384.604,Functional,F,15,44,59
112,11200,-385.382,Non-functional,N,19,0,19
112,11200,-385.382,Functional,F,15,44,59
113,11300,-384.683,Non-functional,N,19,0,19
113,11300,-384.683,Functional,F,15,44,59
114,11400,-385.432,Non-functional,N,19,0,19
114,11400,-385.432,Functional,F,15,44,59
115,11500,-384.739,Non-functional,N,19,0,19
115,11500,-384.739,Functional,F,15,44,59
116,11600,-385.93,Non-functional,N,17,0,17
116,11600,-385.93,Functional,F,14,41,55
117,11700,-386.289,Non-functional,N,17,0,17
117,11700,-386.289,Functional,F,14,41,55
118,11800,-386.079,Non-functional,N,17,0,17
118,11800,-386.079,Functional,F,14,41,55
119,11900,-387.372,Non-functional,N,17,0,17
119,11900,-387.372,Functional,F,14,41,55
120,12000,-386.522,Non-functional,N,17,0,17
120,12000,-386.522,Functional,F,14,41,55
121,12100,-446.42,Non-functional,N,15,0,15
121,12100,-446.42,Functional,F,14,47,61
122,12200,-446.967,Non-functional,N,15,0,15
122,12200,-446.967,Functional,F,14,47,61
123,12300,-447.024,Non-functional,N,15,0,15
123,12300,-447.024,Functional,F,14,47,61
124,12400,-447.418,Non-functional,N,15,0,15
124,12400,-447.418,Functional,F,14,47,61
125,12500,-447.085,Non-functional,N,15,0,15
125,12500,-447.085,Functional,F,14,47,61
126,12600,-405.318,Non-functional,N,20,3,23
126,12600,-405.318,Functional,F,11,42,53
127,12700,-405.371,Non-functional,N,20,3,23
127,12700,-405.371,Functional,F,11,42,53
128,12800,-405.234,Non-functional,N,20,3,23
128,12800,-405.234,Functional,F,11,42,53
129,12900,-406.965,Non-functional,N,20,3,23
129,12900,-406.965,Functional,F,11,42,53
130,13000,-406.19,Non-functional,N,20,3,23
130,13000,-406.19,Functional,F,11,42,53
131,13100,-468.512,Non-functional,N,17,1,18
131,13100,-468.512,Functional,F,13,44,57
132,13200,-468.342,Non-functional,N,17,1,18
132,13200,-468.342,Functional,F,13,44,57
133,13300,-469.806,Non-functional,N,17,1,18
133,13300,-469.806,Functional,F,13,44,57
134,13400,-469.768,Non-functional,N,17,1,18
134,13400,-469.768,Functional,F,13,44,57
135,13500,-470.107,Non-functional,N,17,1,18
135,13500,-470.107,Functional,F,13,44,57
136,13600,-461.783,Non-functional,N,20,2,22
136,13600,-461.783,Functional,F,12,51,63
137,13700,-461.758,Non-functional,N,20,2,22
137,13700,-461.758,Functional,F,12,51,63
138,13800,-462.161,Non-functional,N,20,2,22
138,13800,-462.161,Functional,F,12,51,63
139,13900,-462.139,Non-functional,N,20,2,22
139,13900,-462.139,Functional,F,12,51,63
140,14000,-461.156,Non-functional,N,20,2,22
140,14000,-461.156,Functional,F,12,51,63
141,14100,-392.007,Non-functional,N,22,1,23
141,14100,-392.007,Functional,F,13,37,50
142,14200,-392.672,Non-functional,N,22,1,23
142,14200,-392.672,Functional,F,13,37,50
143,14300,-392.328,Non-functional,N,22,1,23
143,14300,-392.328,Functional,F,13,37,50
144,14400,-392.914,Non-functional,N,22,1,23
144,14400,-392.914,Functional,F,13,37,50
145,14500,-393.072,Non-functional,N,22,1,23
145,14500,-393.072,Functional,F,13,37,50
146,14600,-447.18,Non-functional,N,28,6,34
146,14600,-447.18,Functional,F,9,38,47
147,14700,-447.186,Non-functional,N,28,6,34
147,14700,-447.186,Functional,F,9,38,47
148,14800,-447.582,Non-functional,N,28,6,34
148,14800,-447.582,Functional,F,9,38,47
149,14900,-448.212,Non-functional,N,28,6,34
149,14900,-448.212,Functional,F,9,38,47
150,15000,-448.097,Non-functional,N,28,6,34
150,15000,-448.097,Functional,F,9,38,47
151,15100,-365.285,Non-functional,N,23,7,30
151,15100,-365.285,Functional,F,7,40,47
152,15200,-366.076,Non-functional,N,23,7,30
152,15200,-366.076,Functional,F,7,40,47
153,15300,-366.366,Non-functional,N,23,7,30
153,15300,-366.366,Functional,F,7,40,47
154,15400,-365.866,Non-functional,N,23,7,30
154,15400,-365.866,Functional,F,7,40,47
155,15500,-365.249,Non-functional,N,23,7,30
155,15500,-365.249,Functional,F,7,40,47
156,15600,-362.643,Non-functional,N,18,5,23
156,15600,-362.643,Functional,F,9,39,48
157,15700,-362.255,Non-functional,N,18,5,23
157,15700,-362.255,Functional,F,9,39,48
158,15800,-362.503,Non-functional,N,18,5,23
158,15800,-362.503,Functional,F,9,39,48
159,15900,-362.318,Non-functional,N,18,5,23
159,15900,-362.318,Functional,F,9,39,48
160,16000,-362.239,Non-functional,N,18,5,23
160,16000,-362.239,Functional,F,9,39,48
161,16100,-335.402,Non-functional,N,19,4,23
161,16100,-335.402,Functional,F,10,30,40
162,16200,-336.163,Non-functional,N,19,4,23
162,16200,-336.163,Functional,F,10,30,40
163,16300,-336.22,Non-functional,N,19,4,23
163,16300,-336.22,Functional,F,10,30,40
164,16400,-338.454,Non-functional,N,19,4,23
164,16400,-338.454,Functional,F,10,30,40
165,16500,-336.322,Non-functional,N,19,4,23
165,16500,-336.322,Functional,F,10,30,40
166,16600,-449.977,Non-functional,N,15,4,19
166,16600,-449.977,Functional,F,10,47,57
167,16700,-450.151,Non-functional,N,15,4,19
167,16700,-450.151,Functional,F,10,47,57
168,16800,-452.438,Non-functional,N,15,4,19
168,16800,-452.438,Functional,F,10,47,57
169,16900,-450.396,Non-functional,N,15,4,19
169,16900,-450.396,Functional,F,10,47,57
170,17000,-450.91,Non-functional,N,15,4,19
170,17000,-450.91,Functional,F,10,47,57
171,17100,-419.015,Non-functional,N,25,5,30
171,17100,-419.015,Functional,F,9,34,43
172,17200,-417.9,Non-functional,N,25,5,30
172,17200,-417.9,Functional,F,9,34,43
173,17300,-416.58,Non-functional,N,25,5,30
173,17300,-416.58,Functional,F,9,34,43
174,17400,-416.472,Non-functional,N,25,5,30
174,17400,-416.472,Functional,F,9,34,43
175,17500,-416.43,Non-functional,N,25,5,30
175,17500,-416.43,Functional,F,9,34,43
176,17600,-481.056,Non-functional,N,23,2,25
176,17600,-481.056,Functional,F,12,47,59
177,17700,-482.102,Non-functional,N,23,2,25
177,17700,-482.102,Functional,F,12,47,59
178,17800,-481.125,Non-functional,N,23,2,25
178,17800,-481.125,Functional,F,12,47,59
179,17900,-480.828,Non-functional,N,23,2,25
179,17900,-480.828,Functional,F,12,47,59
180,18000,-479.929,Non-functional,N,23,2,25
180,18000,-479.929,Functional,F,12,47,59
181,18100,-399.341,Non-functional,N,16,3,19
181,18100,-399.341,Functional,F,11,44,55
182,18200,-397.164,Non-functional,N,16,3,19
182,18200,-397.164,Functional,F,11,44,55
183,18300,-398.148,Non-functional,N,16,3,19
183,18300,-398.148,Functional,F,11,44,55
184,18400,-399.163,Non-functional,N,16,3,19
184,18400,-399.163,Functional,F,11,44,55
185,18500,-398.673,Non-functional,N,16,3,19
185,18500,-398.673,Functional,F,11,44,55
186,18600,-396.055,Non-functional,N,14,2,16
186,18600,-396.055,Functional,F,12,46,58
187,18700,-395.493,Non-functional,N,14,2,16
187,18700,-395.493,Functional,F,12,46,58
188,18800,-395.342,Non-functional,N,14,2,16
188,18800,-395.342,Functional,F,12,46,58
189,18900,-394.78,Non-functional,N,14,2,16
189,18900,-394.78,Functional,F,12,46,58
190,19000,-395.347,Non-functional,N,14,2,16
190,19000,-395.347,Functional,F,12,46,58
191,19100,-388.16,Non-functional,N,22,1,23
191,19100,-388.16,Functional,F,13,42,55
192,19200,-387.507,Non-functional,N,22,1,23
192,19200,-387.507,Functional,F,13,42,55
193,19300,-387.466,Non-functional,N,22,1,23
193,19300,-387.466,Functional,F,13,42,55
194,19400,-387.876,Non-functional,N,22,1,23
194,19400,-387.876,Functional,F,13,42,55
195,19500,-386.83,Non-functional,N,22,1,23
195,19500,-386.83,Functional,F,13,42,55
196,19600,-410.56,Non-functional,N,18,3,21
196,19600,-410.56,Functional,F,11,39,50
197,19700,-410.48,Non-functional,N,18,3,21
197,19700,-410.48,Functional,F,11,39,50
198,19800,-409.989,Non-functional,N,18,3,21
198,19800,-409.989,Functional,F,11,39,50
199,19900,-411.785,Non-functional,N,18,3,21
199,19900,-411.785,Functional,F,11,39,50
200,20000,-413.022,Non-functional,N,18,3,21
200,20000,-413.022,Functional,F,11,39,50
