I,GEN,LogL,RateVector,State,a,t,c,g,Total
0,0,-2523.69,RV-order-a,a,7,7,9,5,28
0,0,-2523.69,RV-disorder-a,a,7,5,3,4,19
0,0,-2523.69,RV-order-t,t,4,18,6,5,33
0,0,-2523.69,RV-disorder-t,t,2,11,1,1,15
0,0,-2523.69,RV-order-c,c,7,8,14,8,37
0,0,-2523.69,RV-disorder-c,c,5,4,13,6,28
0,0,-2523.69,RV-order-g,g,5,3,8,4,20
0,0,-2523.69,RV-disorder-g,g,5,2,4,8,19
0,0,-2523.69,RV-O,O,64,43,107
0,0,-2523.69,RV-D,D,39,34,73
1,50,-1958.51,RV-order-a,a,9,8,6,3,26
1,50,-1958.51,RV-disorder-a,a,8,4,6,6,24
1,50,-1958.51,RV-order-t,t,2,16,4,5,27
1,50,-1958.51,RV-disorder-t,t,4,3,3,1,11
1,50,-1958.51,RV-order-c,c,6,4,14,8,32
1,50,-1958.51,RV-disorder-c,c,6,8,8,6,28
1,50,-1958.51,RV-order-g,g,7,4,5,8,24
1,50,-1958.51,RV-disorder-g,g,3,1,7,7,18
1,50,-1958.51,RV-O,O,70,16,86
1,50,-1958.51,RV-D,D,15,45,60
2,100,-1885.69,RV-order-a,a,9,8,6,3,26
2,100,-1885.69,RV-disorder-a,a,8,4,6,6,24
2,100,-1885.69,RV-order-t,t,2,16,4,5,27
2,100,-1885.69,RV-disorder-t,t,4,3,3,1,11
2,100,-1885.69,RV-order-c,c,6,4,14,8,32
2,100,-1885.69,RV-disorder-c,c,6,8,8,6,28
2,100,-1885.69,RV-order-g,g,7,4,5,8,24
2,100,-1885.69,RV-disorder-g,g,3,1,7,7,18
2,100,-1885.69,RV-O,O,70,16,86
2,100,-1885.69,RV-D,D,15,45,60
3,150,-1832.72,RV-order-a,a,9,8,6,3,26
3,150,-1832.72,RV-disorder-a,a,8,4,6,6,24
3,150,-1832.72,RV-order-t,t,2,16,4,5,27
3,150,-1832.72,RV-disorder-t,t,4,3,3,1,11
3,150,-1832.72,RV-order-c,c,6,4,14,8,32
3,150,-1832.72,RV-disorder-c,c,6,8,8,6,28
3,150,-1832.72,RV-order-g,g,7,4,5,8,24
3,150,-1832.72,RV-disorder-g,g,3,1,7,7,18
3,150,-1832.72,RV-O,O,70,16,86
3,150,-1832.72,RV-D,D,15,45,60
4,200,-1809.62,RV-order-a,a,9,8,6,3,26
4,200,-1809.62,RV-disorder-a,a,8,4,6,6,24
4,200,-1809.62,RV-order-t,t,2,16,4,5,27
4,200,-1809.62,RV-disorder-t,t,4,3,3,1,11
4,200,-1809.62,RV-order-c,c,6,4,14,8,32
4,200,-1809.62,RV-disorder-c,c,6,8,8,6,28
4,200,-1809.62,RV-order-g,g,7,4,5,8,24
4,200,-1809.62,RV-disorder-g,g,3,1,7,7,18
4,200,-1809.62,RV-O,O,70,16,86
4,200,-1809.62,RV-D,D,15,45,60
5,250,-1401.37,RV-order-a,a,21,6,3,6,36
5,250,-1401.37,RV-disorder-a,a,9,0,1,1,11
5,250,-1401.37,RV-order-t,t,4,20,3,3,30
5,250,-1401.37,RV-disorder-t,t,2,24,6,3,35
5,250,-1401.37,RV-order-c,c,1,2,6,0,9
5,250,-1401.37,RV-disorder-c,c,0,2,8,1,11
5,250,-1401.37,RV-order-g,g,0,3,1,12,16
5,250,-1401.37,RV-disorder-g,g,0,0,2,6,8
5,250,-1401.37,RV-O,O,70,16,86
5,250,-1401.37,RV-D,D,15,52,67
6,300,-1392.94,RV-order-a,a,21,6,3,6,36
6,300,-1392.94,RV-disorder-a,a,9,0,1,1,11
6,300,-1392.94,RV-order-t,t,4,20,3,3,30
6,300,-1392.94,RV-disorder-t,t,2,24,6,3,35
6,300,-1392.94,RV-order-c,c,1,2,6,0,9
6,300,-1392.94,RV-disorder-c,c,0,2,8,1,11
6,300,-1392.94,RV-order-g,g,0,3,1,12,16
6,300,-1392.94,RV-disorder-g,g,0,0,2,6,8
6,300,-1392.94,RV-O,O,70,16,86
6,300,-1392.94,RV-D,D,15,52,67
7,350,-1387.55,RV-order-a,a,21,6,3,6,36
7,350,-1387.55,RV-disorder-a,a,9,0,1,1,11
7,350,-1387.55,RV-order-t,t,4,20,3,3,30
7,350,-1387.55,RV-disorder-t,t,2,24,6,3,35
7,350,-1387.55,RV-order-c,c,1,2,6,0,9
7,350,-1387.55,RV-disorder-c,c,0,2,8,1,11
7,350,-1387.55,RV-order-g,g,0,3,1,12,16
7,350,-1387.55,RV-disorder-g,g,0,0,2,6,8
7,350,-1387.55,RV-O,O,70,16,86
7,350,-1387.55,RV-D,D,15,52,67
8,400,-1380.36,RV-order-a,a,21,6,3,6,36
8,400,-1380.36,RV-disorder-a,a,9,0,1,1,11
8,400,-1380.36,RV-order-t,t,4,20,3,3,30
8,400,-1380.36,RV-disorder-t,t,2,24,6,3,35
8,400,-1380.36,RV-order-c,c,1,2,6,0,9
8,400,-1380.36,RV-disorder-c,c,0,2,8,1,11
8,400,-1380.36,RV-order-g,g,0,3,1,12,16
8,400,-1380.36,RV-disorder-g,g,0,0,2,6,8
8,400,-1380.36,RV-O,O,70,16,86
8,400,-1380.36,RV-D,D,15,52,67
9,450,-1375.85,RV-order-a,a,21,6,3,6,36
9,450,-1375.85,RV-disorder-a,a,9,0,1,1,11
9,450,-1375.85,RV-order-t,t,4,20,3,3,30
9,450,-1375.85,RV-disorder-t,t,2,24,6,3,35
9,450,-1375.85,RV-order-c,c,1,2,6,0,9
9,450,-1375.85,RV-disorder-c,c,0,2,8,1,11
9,450,-1375.85,RV-order-g,g,0,3,1,12,16
9,450,-1375.85,RV-disorder-g,g,0,0,2,6,8
9,450,-1375.85,RV-O,O,70,16,86
9,450,-1375.85,RV-D,D,15,52,67
10,500,-1366.17,RV-order-a,a,21,6,3,6,36
10,500,-1366.17,RV-disorder-a,a,9,0,1,1,11
10,500,-1366.17,RV-order-t,t,4,20,3,3,30
10,500,-1366.17,RV-disorder-t,t,2,24,6,3,35
10,500,-1366.17,RV-order-c,c,1,2,6,0,9
10,500,-1366.17,RV-disorder-c,c,0,2,8,1,11
10,500,-1366.17,RV-order-g,g,0,3,1,12,16
10,500,-1366.17,RV-disorder-g,g,0,0,2,6,8
10,500,-1366.17,RV-O,O,70,16,86
10,500,-1366.17,RV-D,D,15,52,67
11,550,-1265.66,RV-order-a,a,23,5,1,3,32
11,550,-1265.66,RV-disorder-a,a,13,1,3,4,21
11,550,-1265.66,RV-order-t,t,3,28,8,4,43
11,550,-1265.66,RV-disorder-t,t,3,10,1,2,16
11,550,-1265.66,RV-order-c,c,0,3,4,1,8
11,550,-1265.66,RV-disorder-c,c,1,1,2,0,4
11,550,-1265.66,RV-order-g,g,0,0,2,5,7
11,550,-1265.66,RV-disorder-g,g,0,3,1,9,13
11,550,-1265.66,RV-O,O,54,19,73
11,550,-1265.66,RV-D,D,16,42,58
12,600,-1263.22,RV-order-a,a,23,5,1,3,32
12,600,-1263.22,RV-disorder-a,a,13,1,3,4,21
12,600,-1263.22,RV-order-t,t,3,28,8,4,43
12,600,-1263.22,RV-disorder-t,t,3,10,1,2,16
12,600,-1263.22,RV-order-c,c,0,3,4,1,8
12,600,-1263.22,RV-disorder-c,c,1,1,2,0,4
12,600,-1263.22,RV-order-g,g,0,0,2,5,7
12,600,-1263.22,RV-disorder-g,g,0,3,1,9,13
12,600,-1263.22,RV-O,O,54,19,73
12,600,-1263.22,RV-D,D,16,42,58
13,650,-1258.45,RV-order-a,a,23,5,1,3,32
13,650,-1258.45,RV-disorder-a,a,13,1,3,4,21
13,650,-1258.45,RV-order-t,t,3,28,8,4,43
13,650,-1258.45,RV-disorder-t,t,3,10,1,2,16
13,650,-1258.45,RV-order-c,c,0,3,4,1,8
13,650,-1258.45,RV-disorder-c,c,1,1,2,0,4
13,650,-1258.45,RV-order-g,g,0,0,2,5,7
13,650,-1258.45,RV-disorder-g,g,0,3,1,9,13
13,650,-1258.45,RV-O,O,54,19,73
13,650,-1258.45,RV-D,D,16,42,58
14,700,-1256.3,RV-order-a,a,23,5,1,3,32
14,700,-1256.3,RV-disorder-a,a,13,1,3,4,21
14,700,-1256.3,RV-order-t,t,3,28,8,4,43
14,700,-1256.3,RV-disorder-t,t,3,10,1,2,16
14,700,-1256.3,RV-order-c,c,0,3,4,1,8
14,700,-1256.3,RV-disorder-c,c,1,1,2,0,4
14,700,-1256.3,RV-order-g,g,0,0,2,5,7
14,700,-1256.3,RV-disorder-g,g,0,3,1,9,13
14,700,-1256.3,RV-O,O,54,19,73
14,700,-1256.3,RV-D,D,16,42,58
15,750,-1252.16,RV-order-a,a,23,5,1,3,32
15,750,-1252.16,RV-disorder-a,a,13,1,3,4,21
15,750,-1252.16,RV-order-t,t,3,28,8,4,43
15,750,-1252.16,RV-disorder-t,t,3,10,1,2,16
15,750,-1252.16,RV-order-c,c,0,3,4,1,8
15,750,-1252.16,RV-disorder-c,c,1,1,2,0,4
15,750,-1252.16,RV-order-g,g,0,0,2,5,7
15,750,-1252.16,RV-disorder-g,g,0,3,1,9,13
15,750,-1252.16,RV-O,O,54,19,73
15,750,-1252.16,RV-D,D,16,42,58
16,800,-1392.55,RV-order-a,a,15,4,0,2,21
16,800,-1392.55,RV-disorder-a,a,13,4,6,3,26
16,800,-1392.55,RV-order-t,t,3,18,5,3,29
16,800,-1392.55,RV-disorder-t,t,1,6,1,3,11
16,800,-1392.55,RV-order-c,c,4,5,19,4,32
16,800,-1392.55,RV-disorder-c,c,1,1,2,1,5
16,800,-1392.55,RV-order-g,g,0,3,1,4,8
16,800,-1392.55,RV-disorder-g,g,2,2,1,5,10
16,800,-1392.55,RV-O,O,78,19,97
16,800,-1392.55,RV-D,D,16,53,69
17,850,-1388.2,RV-order-a,a,15,4,0,2,21
17,850,-1388.2,RV-disorder-a,a,13,4,6,3,26
17,850,-1388.2,RV-order-t,t,3,18,5,3,29
17,850,-1388.2,RV-disorder-t,t,1,6,1,3,11
17,850,-1388.2,RV-order-c,c,4,5,19,4,32
17,850,-1388.2,RV-disorder-c,c,1,1,2,1,5
17,850,-1388.2,RV-order-g,g,0,3,1,4,8
17,850,-1388.2,RV-disorder-g,g,2,2,1,5,10
17,850,-1388.2,RV-O,O,78,19,97
17,850,-1388.2,RV-D,D,16,53,69
18,900,-1384.97,RV-order-a,a,15,4,0,2,21
18,900,-1384.97,RV-disorder-a,a,13,4,6,3,26
18,900,-1384.97,RV-order-t,t,3,18,5,3,29
18,900,-1384.97,RV-disorder-t,t,1,6,1,3,11
18,900,-1384.97,RV-order-c,c,4,5,19,4,32
18,900,-1384.97,RV-disorder-c,c,1,1,2,1,5
18,900,-1384.97,RV-order-g,g,0,3,1,4,8
18,900,-1384.97,RV-disorder-g,g,2,2,1,5,10
18,900,-1384.97,RV-O,O,78,19,97
18,900,-1384.97,RV-D,D,16,53,69
19,950,-1385.18,RV-order-a,a,15,4,0,2,21
19,950,-1385.18,RV-disorder-a,a,13,4,6,3,26
19,950,-1385.18,RV-order-t,t,3,18,5,3,29
19,950,-1385.18,RV-disorder-t,t,1,6,1,3,11
19,950,-1385.18,RV-order-c,c,4,5,19,4,32
19,950,-1385.18,RV-disorder-c,c,1,1,2,1,5
19,950,-1385.18,RV-order-g,g,0,3,1,4,8
19,950,-1385.18,RV-disorder-g,g,2,2,1,5,10
19,950,-1385.18,RV-O,O,78,19,97
19,950,-1385.18,RV-D,D,16,53,69
20,1000,-1384.63,RV-order-a,a,15,4,0,2,21
20,1000,-1384.63,RV-disorder-a,a,13,4,6,3,26
20,1000,-1384.63,RV-order-t,t,3,18,5,3,29
20,1000,-1384.63,RV-disorder-t,t,1,6,1,3,11
20,1000,-1384.63,RV-order-c,c,4,5,19,4,32
20,1000,-1384.63,RV-disorder-c,c,1,1,2,1,5
20,1000,-1384.63,RV-order-g,g,0,3,1,4,8
20,1000,-1384.63,RV-disorder-g,g,2,2,1,5,10
20,1000,-1384.63,RV-O,O,78,19,97
20,1000,-1384.63,RV-D,D,16,53,69
21,1050,-1304.8,RV-order-a,a,20,5,4,2,31
21,1050,-1304.8,RV-disorder-a,a,7,3,2,3,15
21,1050,-1304.8,RV-order-t,t,2,15,2,5,24
21,1050,-1304.8,RV-disorder-t,t,2,15,4,1,22
21,1050,-1304.8,RV-order-c,c,1,3,6,2,12
21,1050,-1304.8,RV-disorder-c,c,4,3,18,3,28
21,1050,-1304.8,RV-order-g,g,2,2,1,4,9
21,1050,-1304.8,RV-disorder-g,g,0,3,1,5,9
21,1050,-1304.8,RV-O,O,62,13,75
21,1050,-1304.8,RV-D,D,16,50,66
22,1100,-1302.39,RV-order-a,a,20,5,4,2,31
22,1100,-1302.39,RV-disorder-a,a,7,3,2,3,15
22,1100,-1302.39,RV-order-t,t,2,15,2,5,24
22,1100,-1302.39,RV-disorder-t,t,2,15,4,1,22
22,1100,-1302.39,RV-order-c,c,1,3,6,2,12
22,1100,-1302.39,RV-disorder-c,c,4,3,18,3,28
22,1100,-1302.39,RV-order-g,g,2,2,1,4,9
22,1100,-1302.39,RV-disorder-g,g,0,3,1,5,9
22,1100,-1302.39,RV-O,O,62,13,75
22,1100,-1302.39,RV-D,D,16,50,66
23,1150,-1296.36,RV-order-a,a,20,5,4,2,31
23,1150,-1296.36,RV-disorder-a,a,7,3,2,3,15
23,1150,-1296.36,RV-order-t,t,2,15,2,5,24
23,1150,-1296.36,RV-disorder-t,t,2,15,4,1,22
23,1150,-1296.36,RV-order-c,c,1,3,6,2,12
23,1150,-1296.36,RV-disorder-c,c,4,3,18,3,28
23,1150,-1296.36,RV-order-g,g,2,2,1,4,9
23,1150,-1296.36,RV-disorder-g,g,0,3,1,5,9
23,1150,-1296.36,RV-O,O,62,13,75
23,1150,-1296.36,RV-D,D,16,50,66
24,1200,-1293.76,RV-order-a,a,20,5,4,2,31
24,1200,-1293.76,RV-disorder-a,a,7,3,2,3,15
24,1200,-1293.76,RV-order-t,t,2,15,2,5,24
24,1200,-1293.76,RV-disorder-t,t,2,15,4,1,22
24,1200,-1293.76,RV-order-c,c,1,3,6,2,12
24,1200,-1293.76,RV-disorder-c,c,4,3,18,3,28
24,1200,-1293.76,RV-order-g,g,2,2,1,4,9
24,1200,-1293.76,RV-disorder-g,g,0,3,1,5,9
24,1200,-1293.76,RV-O,O,62,13,75
24,1200,-1293.76,RV-D,D,16,50,66
25,1250,-1291.58,RV-order-a,a,20,5,4,2,31
25,1250,-1291.58,RV-disorder-a,a,7,3,2,3,15
25,1250,-1291.58,RV-order-t,t,2,15,2,5,24
25,1250,-1291.58,RV-disorder-t,t,2,15,4,1,22
25,1250,-1291.58,RV-order-c,c,1,3,6,2,12
25,1250,-1291.58,RV-disorder-c,c,4,3,18,3,28
25,1250,-1291.58,RV-order-g,g,2,2,1,4,9
25,1250,-1291.58,RV-disorder-g,g,0,3,1,5,9
25,1250,-1291.58,RV-O,O,62,13,75
25,1250,-1291.58,RV-D,D,16,50,66
26,1300,-1253.13,RV-order-a,a,10,1,2,3,16
26,1300,-1253.13,RV-disorder-a,a,11,1,2,1,15
26,1300,-1253.13,RV-order-t,t,4,28,4,4,40
26,1300,-1253.13,RV-disorder-t,t,2,14,3,1,20
26,1300,-1253.13,RV-order-c,c,3,3,10,1,17
26,1300,-1253.13,RV-disorder-c,c,0,3,6,1,10
26,1300,-1253.13,RV-order-g,g,1,4,0,7,12
26,1300,-1253.13,RV-disorder-g,g,0,2,3,10,15
26,1300,-1253.13,RV-O,O,61,13,74
26,1300,-1253.13,RV-D,D,16,54,70
27,1350,-1250.43,RV-order-a,a,10,1,2,3,16
27,1350,-1250.43,RV-disorder-a,a,11,1,2,1,15
27,1350,-1250.43,RV-order-t,t,4,28,4,4,40
27,1350,-1250.43,RV-disorder-t,t,2,14,3,1,20
27,1350,-1250.43,RV-order-c,c,3,3,10,1,17
27,1350,-1250.43,RV-disorder-c,c,0,3,6,1,10
27,1350,-1250.43,RV-order-g,g,1,4,0,7,12
27,1350,-1250.43,RV-disorder-g,g,0,2,3,10,15
27,1350,-1250.43,RV-O,O,61,13,74
27,1350,-1250.43,RV-D,D,16,54,70
28,1400,-1249.36,RV-order-a,a,10,1,2,3,16
28,1400,-1249.36,RV-disorder-a,a,11,1,2,1,15
28,1400,-1249.36,RV-order-t,t,4,28,4,4,40
28,1400,-1249.36,RV-disorder-t,t,2,14,3,1,20
28,1400,-1249.36,RV-order-c,c,3,3,10,1,17
28,1400,-1249.36,RV-disorder-c,c,0,3,6,1,10
28,1400,-1249.36,RV-order-g,g,1,4,0,7,12
28,1400,-1249.36,RV-disorder-g,g,0,2,3,10,15
28,1400,-1249.36,RV-O,O,61,13,74
28,1400,-1249.36,RV-D,D,16,54,70
29,1450,-1249.61,RV-order-a,a,10,1,2,3,16
29,1450,-1249.61,RV-disorder-a,a,11,1,2,1,15
29,1450,-1249.61,RV-order-t,t,4,28,4,4,40
29,1450,-1249.61,RV-disorder-t,t,2,14,3,1,20
29,1450,-1249.61,RV-order-c,c,3,3,10,1,17
29,1450,-1249.61,RV-disorder-c,c,0,3,6,1,10
29,1450,-1249.61,RV-order-g,g,1,4,0,7,12
29,1450,-1249.61,RV-disorder-g,g,0,2,3,10,15
29,1450,-1249.61,RV-O,O,61,13,74
29,1450,-1249.61,RV-D,D,16,54,70
30,1500,-1247.37,RV-order-a,a,10,1,2,3,16
30,1500,-1247.37,RV-disorder-a,a,11,1,2,1,15
30,1500,-1247.37,RV-order-t,t,4,28,4,4,40
30,1500,-1247.37,RV-disorder-t,t,2,14,3,1,20
30,1500,-1247.37,RV-order-c,c,3,3,10,1,17
30,1500,-1247.37,RV-disorder-c,c,0,3,6,1,10
30,1500,-1247.37,RV-order-g,g,1,4,0,7,12
30,1500,-1247.37,RV-disorder-g,g,0,2,3,10,15
30,1500,-1247.37,RV-O,O,61,13,74
30,1500,-1247.37,RV-D,D,16,54,70
31,1550,-1318.5,RV-order-a,a,18,1,1,1,21
31,1550,-1318.5,RV-disorder-a,a,7,1,3,3,14
31,1550,-1318.5,RV-order-t,t,4,33,7,2,46
31,1550,-1318.5,RV-disorder-t,t,2,12,0,3,17
31,1550,-1318.5,RV-order-c,c,1,5,15,1,22
31,1550,-1318.5,RV-disorder-c,c,2,1,8,1,12
31,1550,-1318.5,RV-order-g,g,1,3,3,10,17
31,1550,-1318.5,RV-disorder-g,g,0,3,0,5,8
31,1550,-1318.5,RV-O,O,75,21,96
31,1550,-1318.5,RV-D,D,10,44,54
32,1600,-1317.5,RV-order-a,a,18,1,1,1,21
32,1600,-1317.5,RV-disorder-a,a,7,1,3,3,14
32,1600,-1317.5,RV-order-t,t,4,33,7,2,46
32,1600,-1317.5,RV-disorder-t,t,2,12,0,3,17
32,1600,-1317.5,RV-order-c,c,1,5,15,1,22
32,1600,-1317.5,RV-disorder-c,c,2,1,8,1,12
32,1600,-1317.5,RV-order-g,g,1,3,3,10,17
32,1600,-1317.5,RV-disorder-g,g,0,3,0,5,8
32,1600,-1317.5,RV-O,O,75,21,96
32,1600,-1317.5,RV-D,D,10,44,54
33,1650,-1316.31,RV-order-a,a,18,1,1,1,21
33,1650,-1316.31,RV-disorder-a,a,7,1,3,3,14
33,1650,-1316.31,RV-order-t,t,4,33,7,2,46
33,1650,-1316.31,RV-disorder-t,t,2,12,0,3,17
33,1650,-1316.31,RV-order-c,c,1,5,15,1,22
33,1650,-1316.31,RV-disorder-c,c,2,1,8,1,12
33,1650,-1316.31,RV-order-g,g,1,3,3,10,17
33,1650,-1316.31,RV-disorder-g,g,0,3,0,5,8
33,1650,-1316.31,RV-O,O,75,21,96
33,1650,-1316.31,RV-D,D,10,44,54
34,1700,-1315.35,RV-order-a,a,18,1,1,1,21
34,1700,-1315.35,RV-disorder-a,a,7,1,3,3,14
34,1700,-1315.35,RV-order-t,t,4,33,7,2,46
34,1700,-1315.35,RV-disorder-t,t,2,12,0,3,17
34,1700,-1315.35,RV-order-c,c,1,5,15,1,22
34,1700,-1315.35,RV-disorder-c,c,2,1,8,1,12
34,1700,-1315.35,RV-order-g,g,1,3,3,10,17
34,1700,-1315.35,RV-disorder-g,g,0,3,0,5,8
34,1700,-1315.35,RV-O,O,75,21,96
34,1700,-1315.35,RV-D,D,10,44,54
35,1750,-1316.61,RV-order-a,a,18,1,1,1,21
35,1750,-1316.61,RV-disorder-a,a,7,1,3,3,14
35,1750,-1316.61,RV-order-t,t,4,33,7,2,46
35,1750,-1316.61,RV-disorder-t,t,2,12,0,3,17
35,1750,-1316.61,RV-order-c,c,1,5,15,1,22
35,1750,-1316.61,RV-disorder-c,c,2,1,8,1,12
35,1750,-1316.61,RV-order-g,g,1,3,3,10,17
35,1750,-1316.61,RV-disorder-g,g,0,3,0,5,8
35,1750,-1316.61,RV-O,O,75,21,96
35,1750,-1316.61,RV-D,D,10,44,54
36,1800,-1320.22,RV-order-a,a,20,7,2,1,30
36,1800,-1320.22,RV-disorder-a,a,16,3,6,3,28
36,1800,-1320.22,RV-order-t,t,2,22,5,5,34
36,1800,-1320.22,RV-disorder-t,t,0,9,0,3,12
36,1800,-1320.22,RV-order-c,c,0,6,21,5,32
36,1800,-1320.22,RV-disorder-c,c,0,1,0,1,2
36,1800,-1320.22,RV-order-g,g,0,1,0,0,1
36,1800,-1320.22,RV-disorder-g,g,2,2,0,3,7
36,1800,-1320.22,RV-O,O,80,21,101
36,1800,-1320.22,RV-D,D,10,48,58
37,1850,-1317.69,RV-order-a,a,20,7,2,1,30
37,1850,-1317.69,RV-disorder-a,a,16,3,6,3,28
37,1850,-1317.69,RV-order-t,t,2,22,5,5,34
37,1850,-1317.69,RV-disorder-t,t,0,9,0,3,12
37,1850,-1317.69,RV-order-c,c,0,6,21,5,32
37,1850,-1317.69,RV-disorder-c,c,0,1,0,1,2
37,1850,-1317.69,RV-order-g,g,0,1,0,0,1
37,1850,-1317.69,RV-disorder-g,g,2,2,0,3,7
37,1850,-1317.69,RV-O,O,80,21,101
37,1850,-1317.69,RV-D,D,10,48,58
38,1900,-1317.67,RV-order-a,a,20,7,2,1,30
38,1900,-1317.67,RV-disorder-a,a,16,3,6,3,28
38,1900,-1317.67,RV-order-t,t,2,22,5,5,34
38,1900,-1317.67,RV-disorder-t,t,0,9,0,3,12
38,1900,-1317.67,RV-order-c,c,0,6,21,5,32
38,1900,-1317.67,RV-disorder-c,c,0,1,0,1,2
38,1900,-1317.67,RV-order-g,g,0,1,0,0,1
38,1900,-1317.67,RV-disorder-g,g,2,2,0,3,7
38,1900,-1317.67,RV-O,O,80,21,101
38,1900,-1317.67,RV-D,D,10,48,58
39,1950,-1317.37,RV-order-a,a,20,7,2,1,30
39,1950,-1317.37,RV-disorder-a,a,16,3,6,3,28
39,1950,-1317.37,RV-order-t,t,2,22,5,5,34
39,1950,-1317.37,RV-disorder-t,t,0,9,0,3,12
39,1950,-1317.37,RV-order-c,c,0,6,21,5,32
39,1950,-1317.37,RV-disorder-c,c,0,1,0,1,2
39,1950,-1317.37,RV-order-g,g,0,1,0,0,1
39,1950,-1317.37,RV-disorder-g,g,2,2,0,3,7
39,1950,-1317.37,RV-O,O,80,21,101
39,1950,-1317.37,RV-D,D,10,48,58
40,2000,-1316.31,RV-order-a,a,20,7,2,1,30
40,2000,-1316.31,RV-disorder-a,a,16,3,6,3,28
40,2000,-1316.31,RV-order-t,t,2,22,5,5,34
40,2000,-1316.31,RV-disorder-t,t,0,9,0,3,12
40,2000,-1316.31,RV-order-c,c,0,6,21,5,32
40,2000,-1316.31,RV-disorder-c,c,0,1,0,1,2
40,2000,-1316.31,RV-order-g,g,0,1,0,0,1
40,2000,-1316.31,RV-disorder-g,g,2,2,0,3,7
40,2000,-1316.31,RV-O,O,80,21,101
40,2000,-1316.31,RV-D,D,10,48,58
