I,GEN,LogL,RateVector,State,a,t,c,g,Total
0,0,-1683.32,RV-order-a,a,24,5,4,1,34
0,0,-1683.32,RV-disorder-a,a,8,0,1,2,11
0,0,-1683.32,RV-order-t,t,4,21,5,2,32
0,0,-1683.32,RV-disorder-t,t,2,13,2,1,18
0,0,-1683.32,RV-order-c,c,4,3,16,1,24
0,0,-1683.32,RV-disorder-c,c,1,1,14,4,20
0,0,-1683.32,RV-order-g,g,1,5,4,11,21
0,0,-1683.32,RV-disorder-g,g,0,4,0,6,10
0,0,-1683.32,RV-O,O,69,18,87
0,0,-1683.32,RV-D,D,19,48,67
1,100,-1562.75,RV-order-a,a,24,5,4,1,34
1,100,-1562.75,RV-disorder-a,a,8,0,1,2,11
1,100,-1562.75,RV-order-t,t,4,21,5,2,32
1,100,-1562.75,RV-disorder-t,t,2,13,2,1,18
1,100,-1562.75,RV-order-c,c,4,3,16,1,24
1,100,-1562.75,RV-disorder-c,c,1,1,14,4,20
1,100,-1562.75,RV-order-g,g,1,5,4,11,21
1,100,-1562.75,RV-disorder-g,g,0,4,0,6,10
1,100,-1562.75,RV-O,O,69,18,87
1,100,-1562.75,RV-D,D,19,48,67
2,200,-1516.95,RV-order-a,a,24,5,4,1,34
2,200,-1516.95,RV-disorder-a,a,8,0,1,2,11
2,200,-1516.95,RV-order-t,t,4,21,5,2,32
2,200,-1516.95,RV-disorder-t,t,2,13,2,1,18
2,200,-1516.95,RV-order-c,c,4,3,16,1,24
2,200,-1516.95,RV-disorder-c,c,1,1,14,4,20
2,200,-1516.95,RV-order-g,g,1,5,4,11,21
2,200,-1516.95,RV-disorder-g,g,0,4,0,6,10
2,200,-1516.95,RV-O,O,69,18,87
2,200,-1516.95,RV-D,D,19,48,67
3,300,-1455.49,RV-order-a,a,15,3,1,1,20
3,300,-1455.49,RV-disorder-a,a,9,0,4,2,15
3,300,-1455.49,RV-order-t,t,4,26,7,3,40
3,300,-1455.49,RV-disorder-t,t,1,18,1,5,25
3,300,-1455.49,RV-order-c,c,2,4,14,2,22
3,300,-1455.49,RV-disorder-c,c,0,2,7,2,11
3,300,-1455.49,RV-order-g,g,1,3,1,5,10
3,300,-1455.49,RV-disorder-g,g,1,2,2,10,15
3,300,-1455.49,RV-O,O,79,20,99
3,300,-1455.49,RV-D,D,16,40,56
4,400,-1435.75,RV-order-a,a,15,3,1,1,20
4,400,-1435.75,RV-disorder-a,a,9,0,4,2,15
4,400,-1435.75,RV-order-t,t,4,26,7,3,40
4,400,-1435.75,RV-disorder-t,t,1,18,1,5,25
4,400,-1435.75,RV-order-c,c,2,4,14,2,22
4,400,-1435.75,RV-disorder-c,c,0,2,7,2,11
4,400,-1435.75,RV-order-g,g,1,3,1,5,10
4,400,-1435.75,RV-disorder-g,g,1,2,2,10,15
4,400,-1435.75,RV-O,O,79,20,99
4,400,-1435.75,RV-D,D,16,40,56
5,500,-1424.11,RV-order-a,a,15,3,1,1,20
5,500,-1424.11,RV-disorder-a,a,9,0,4,2,15
5,500,-1424.11,RV-order-t,t,4,26,7,3,40
5,500,-1424.11,RV-disorder-t,t,1,18,1,5,25
5,500,-1424.11,RV-order-c,c,2,4,14,2,22
5,500,-1424.11,RV-disorder-c,c,0,2,7,2,11
5,500,-1424.11,RV-order-g,g,1,3,1,5,10
5,500,-1424.11,RV-disorder-g,g,1,2,2,10,15
5,500,-1424.11,RV-O,O,79,20,99
5,500,-1424.11,RV-D,D,16,40,56
6,600,-1454.04,RV-order-a,a,12,6,1,3,22
6,600,-1454.04,RV-disorder-a,a,13,1,4,3,21
6,600,-1454.04,RV-order-t,t,5,30,3,4,42
6,600,-1454.04,RV-disorder-t,t,2,11,2,3,18
6,600,-1454.04,RV-order-c,c,2,4,13,2,21
6,600,-1454.04,RV-disorder-c,c,0,5,8,0,13
6,600,-1454.04,RV-order-g,g,1,1,2,6,10
6,600,-1454.04,RV-disorder-g,g,1,2,3,8,14
6,600,-1454.04,RV-O,O,70,24,94
6,600,-1454.04,RV-D,D,20,34,54
7,700,-1443.72,RV-order-a,a,12,6,1,3,22
7,700,-1443.72,RV-disorder-a,a,13,1,4,3,21
7,700,-1443.72,RV-order-t,t,5,30,3,4,42
7,700,-1443.72,RV-disorder-t,t,2,11,2,3,18
7,700,-1443.72,RV-order-c,c,2,4,13,2,21
7,700,-1443.72,RV-disorder-c,c,0,5,8,0,13
7,700,-1443.72,RV-order-g,g,1,1,2,6,10
7,700,-1443.72,RV-disorder-g,g,1,2,3,8,14
7,700,-1443.72,RV-O,O,70,24,94
7,700,-1443.72,RV-D,D,20,34,54
8,800,-1452.82,RV-order-a,a,17,3,4,0,24
8,800,-1452.82,RV-disorder-a,a,16,2,2,5,25
8,800,-1452.82,RV-order-t,t,2,29,3,5,39
8,800,-1452.82,RV-disorder-t,t,2,8,1,3,14
8,800,-1452.82,RV-order-c,c,2,4,11,1,18
8,800,-1452.82,RV-disorder-c,c,1,3,12,0,16
8,800,-1452.82,RV-order-g,g,3,5,4,5,17
8,800,-1452.82,RV-disorder-g,g,0,3,2,6,11
8,800,-1452.82,RV-O,O,61,25,86
8,800,-1452.82,RV-D,D,17,48,65
9,900,-1447.26,RV-order-a,a,17,3,4,0,24
9,900,-1447.26,RV-disorder-a,a,16,2,2,5,25
9,900,-1447.26,RV-order-t,t,2,29,3,5,39
9,900,-1447.26,RV-disorder-t,t,2,8,1,3,14
9,900,-1447.26,RV-order-c,c,2,4,11,1,18
9,900,-1447.26,RV-disorder-c,c,1,3,12,0,16
9,900,-1447.26,RV-order-g,g,3,5,4,5,17
9,900,-1447.26,RV-disorder-g,g,0,3,2,6,11
9,900,-1447.26,RV-O,O,61,25,86
9,900,-1447.26,RV-D,D,17,48,65
10,1000,-1441.46,RV-order-a,a,17,3,4,0,24
10,1000,-1441.46,RV-disorder-a,a,16,2,2,5,25
10,1000,-1441.46,RV-order-t,t,2,29,3,5,39
10,1000,-1441.46,RV-disorder-t,t,2,8,1,3,14
10,1000,-1441.46,RV-order-c,c,2,4,11,1,18
10,1000,-1441.46,RV-disorder-c,c,1,3,12,0,16
10,1000,-1441.46,RV-order-g,g,3,5,4,5,17
10,1000,-1441.46,RV-disorder-g,g,0,3,2,6,11
10,1000,-1441.46,RV-O,O,61,25,86
10,1000,-1441.46,RV-D,D,17,48,65
