I,GEN,LogL,RateVector,State,a,t,c,g,Total
0,0,-1670.36,RV-order-a,a,14,3,1,1,19
0,0,-1670.36,RV-disorder-a,a,8,0,2,2,12
0,0,-1670.36,RV-order-t,t,3,27,8,1,39
0,0,-1670.36,RV-disorder-t,t,2,14,2,5,23
0,0,-1670.36,RV-order-c,c,0,3,17,3,23
0,0,-1670.36,RV-disorder-c,c,3,1,6,0,10
0,0,-1670.36,RV-order-g,g,3,5,1,16,25
0,0,-1670.36,RV-disorder-g,g,0,3,1,6,10
0,0,-1670.36,RV-O,O,74,18,92
0,0,-1670.36,RV-D,D,24,40,64
1,50,-1486.81,RV-order-a,a,14,1,2,2,19
1,50,-1486.81,RV-disorder-a,a,8,2,1,1,12
1,50,-1486.81,RV-order-t,t,4,30,5,6,45
1,50,-1486.81,RV-disorder-t,t,1,13,5,0,19
1,50,-1486.81,RV-order-c,c,1,4,9,1,15
1,50,-1486.81,RV-disorder-c,c,2,0,11,2,15
1,50,-1486.81,RV-order-g,g,2,8,1,15,26
1,50,-1486.81,RV-disorder-g,g,1,0,1,6,8
1,50,-1486.81,RV-O,O,85,19,104
1,50,-1486.81,RV-D,D,10,40,50
2,100,-1454.02,RV-order-a,a,14,1,2,2,19
2,100,-1454.02,RV-disorder-a,a,8,2,1,1,12
2,100,-1454.02,RV-order-t,t,4,30,5,6,45
2,100,-1454.02,RV-disorder-t,t,1,13,5,0,19
2,100,-1454.02,RV-order-c,c,1,4,9,1,15
2,100,-1454.02,RV-disorder-c,c,2,0,11,2,15
2,100,-1454.02,RV-order-g,g,2,8,1,15,26
2,100,-1454.02,RV-disorder-g,g,1,0,1,6,8
2,100,-1454.02,RV-O,O,85,19,104
2,100,-1454.02,RV-D,D,10,40,50
3,150,-1442.34,RV-order-a,a,14,1,2,2,19
3,150,-1442.34,RV-disorder-a,a,8,2,1,1,12
3,150,-1442.34,RV-order-t,t,4,30,5,6,45
3,150,-1442.34,RV-disorder-t,t,1,13,5,0,19
3,150,-1442.34,RV-order-c,c,1,4,9,1,15
3,150,-1442.34,RV-disorder-c,c,2,0,11,2,15
3,150,-1442.34,RV-order-g,g,2,8,1,15,26
3,150,-1442.34,RV-disorder-g,g,1,0,1,6,8
3,150,-1442.34,RV-O,O,85,19,104
3,150,-1442.34,RV-D,D,10,40,50
4,200,-1429,RV-order-a,a,14,1,2,2,19
4,200,-1429,RV-disorder-a,a,8,2,1,1,12
4,200,-1429,RV-order-t,t,4,30,5,6,45
4,200,-1429,RV-disorder-t,t,1,13,5,0,19
4,200,-1429,RV-order-c,c,1,4,9,1,15
4,200,-1429,RV-disorder-c,c,2,0,11,2,15
4,200,-1429,RV-order-g,g,2,8,1,15,26
4,200,-1429,RV-disorder-g,g,1,0,1,6,8
4,200,-1429,RV-O,O,85,19,104
4,200,-1429,RV-D,D,10,40,50
5,250,-1448.1,RV-order-a,a,21,7,5,4,37
5,250,-1448.1,RV-disorder-a,a,9,0,2,1,12
5,250,-1448.1,RV-order-t,t,3,21,1,4,29
5,250,-1448.1,RV-disorder-t,t,3,5,0,1,9
5,250,-1448.1,RV-order-c,c,2,4,13,2,21
5,250,-1448.1,RV-disorder-c,c,0,4,11,0,15
5,250,-1448.1,RV-order-g,g,0,4,4,15,23
5,250,-1448.1,RV-disorder-g,g,2,1,3,11,17
5,250,-1448.1,RV-O,O,83,19,102
5,250,-1448.1,RV-D,D,10,40,50
6,300,-1441.22,RV-order-a,a,21,7,5,4,37
6,300,-1441.22,RV-disorder-a,a,9,0,2,1,12
6,300,-1441.22,RV-order-t,t,3,21,1,4,29
6,300,-1441.22,RV-disorder-t,t,3,5,0,1,9
6,300,-1441.22,RV-order-c,c,2,4,13,2,21
6,300,-1441.22,RV-disorder-c,c,0,4,11,0,15
6,300,-1441.22,RV-order-g,g,0,4,4,15,23
6,300,-1441.22,RV-disorder-g,g,2,1,3,11,17
6,300,-1441.22,RV-O,O,83,19,102
6,300,-1441.22,RV-D,D,10,40,50
7,350,-1424.62,RV-order-a,a,21,7,5,4,37
7,350,-1424.62,RV-disorder-a,a,9,0,2,1,12
7,350,-1424.62,RV-order-t,t,3,21,1,4,29
7,350,-1424.62,RV-disorder-t,t,3,5,0,1,9
7,350,-1424.62,RV-order-c,c,2,4,13,2,21
7,350,-1424.62,RV-disorder-c,c,0,4,11,0,15
7,350,-1424.62,RV-order-g,g,0,4,4,15,23
7,350,-1424.62,RV-disorder-g,g,2,1,3,11,17
7,350,-1424.62,RV-O,O,83,19,102
7,350,-1424.62,RV-D,D,10,40,50
8,400,-1418.46,RV-order-a,a,21,7,5,4,37
8,400,-1418.46,RV-disorder-a,a,9,0,2,1,12
8,400,-1418.46,RV-order-t,t,3,21,1,4,29
8,400,-1418.46,RV-disorder-t,t,3,5,0,1,9
8,400,-1418.46,RV-order-c,c,2,4,13,2,21
8,400,-1418.46,RV-disorder-c,c,0,4,11,0,15
8,400,-1418.46,RV-order-g,g,0,4,4,15,23
8,400,-1418.46,RV-disorder-g,g,2,1,3,11,17
8,400,-1418.46,RV-O,O,83,19,102
8,400,-1418.46,RV-D,D,10,40,50
9,450,-1419.74,RV-order-a,a,21,7,5,4,37
9,450,-1419.74,RV-disorder-a,a,9,0,2,1,12
9,450,-1419.74,RV-order-t,t,3,21,1,4,29
9,450,-1419.74,RV-disorder-t,t,3,5,0,1,9
9,450,-1419.74,RV-order-c,c,2,4,13,2,21
9,450,-1419.74,RV-disorder-c,c,0,4,11,0,15
9,450,-1419.74,RV-order-g,g,0,4,4,15,23
9,450,-1419.74,RV-disorder-g,g,2,1,3,11,17
9,450,-1419.74,RV-O,O,83,19,102
9,450,-1419.74,RV-D,D,10,40,50
10,500,-1411.77,RV-order-a,a,21,7,5,4,37
10,500,-1411.77,RV-disorder-a,a,9,0,2,1,12
10,500,-1411.77,RV-order-t,t,3,21,1,4,29
10,500,-1411.77,RV-disorder-t,t,3,5,0,1,9
10,500,-1411.77,RV-order-c,c,2,4,13,2,21
10,500,-1411.77,RV-disorder-c,c,0,4,11,0,15
10,500,-1411.77,RV-order-g,g,0,4,4,15,23
10,500,-1411.77,RV-disorder-g,g,2,1,3,11,17
10,500,-1411.77,RV-O,O,83,19,102
10,500,-1411.77,RV-D,D,10,40,50
11,550,-1378.64,RV-order-a,a,23,6,5,4,38
11,550,-1378.64,RV-disorder-a,a,9,1,2,1,13
11,550,-1378.64,RV-order-t,t,5,15,0,2,22
11,550,-1378.64,RV-disorder-t,t,1,9,1,3,14
11,550,-1378.64,RV-order-c,c,0,4,12,0,16
11,550,-1378.64,RV-disorder-c,c,2,4,10,2,18
11,550,-1378.64,RV-order-g,g,2,1,4,7,14
11,550,-1378.64,RV-disorder-g,g,0,4,3,10,17
11,550,-1378.64,RV-O,O,74,18,92
11,550,-1378.64,RV-D,D,15,41,56
12,600,-1375.32,RV-order-a,a,23,6,5,4,38
12,600,-1375.32,RV-disorder-a,a,9,1,2,1,13
12,600,-1375.32,RV-order-t,t,5,15,0,2,22
12,600,-1375.32,RV-disorder-t,t,1,9,1,3,14
12,600,-1375.32,RV-order-c,c,0,4,12,0,16
12,600,-1375.32,RV-disorder-c,c,2,4,10,2,18
12,600,-1375.32,RV-order-g,g,2,1,4,7,14
12,600,-1375.32,RV-disorder-g,g,0,4,3,10,17
12,600,-1375.32,RV-O,O,74,18,92
12,600,-1375.32,RV-D,D,15,41,56
13,650,-1373.46,RV-order-a,a,23,6,5,4,38
13,650,-1373.46,RV-disorder-a,a,9,1,2,1,13
13,650,-1373.46,RV-order-t,t,5,15,0,2,22
13,650,-1373.46,RV-disorder-t,t,1,9,1,3,14
13,650,-1373.46,RV-order-c,c,0,4,12,0,16
13,650,-1373.46,RV-disorder-c,c,2,4,10,2,18
13,650,-1373.46,RV-order-g,g,2,1,4,7,14
13,650,-1373.46,RV-disorder-g,g,0,4,3,10,17
13,650,-1373.46,RV-O,O,74,18,92
13,650,-1373.46,RV-D,D,15,41,56
14,700,-1371.98,RV-order-a,a,23,6,5,4,38
14,700,-1371.98,RV-disorder-a,a,9,1,2,1,13
14,700,-1371.98,RV-order-t,t,5,15,0,2,22
14,700,-1371.98,RV-disorder-t,t,1,9,1,3,14
14,700,-1371.98,RV-order-c,c,0,4,12,0,16
14,700,-1371.98,RV-disorder-c,c,2,4,10,2,18
14,700,-1371.98,RV-order-g,g,2,1,4,7,14
14,700,-1371.98,RV-disorder-g,g,0,4,3,10,17
14,700,-1371.98,RV-O,O,74,18,92
14,700,-1371.98,RV-D,D,15,41,56
15,750,-1365.98,RV-order-a,a,23,6,5,4,38
15,750,-1365.98,RV-disorder-a,a,9,1,2,1,13
15,750,-1365.98,RV-order-t,t,5,15,0,2,22
15,750,-1365.98,RV-disorder-t,t,1,9,1,3,14
15,750,-1365.98,RV-order-c,c,0,4,12,0,16
15,750,-1365.98,RV-disorder-c,c,2,4,10,2,18
15,750,-1365.98,RV-order-g,g,2,1,4,7,14
15,750,-1365.98,RV-disorder-g,g,0,4,3,10,17
15,750,-1365.98,RV-O,O,74,18,92
15,750,-1365.98,RV-D,D,15,41,56
16,800,-1433.63,RV-order-a,a,18,5,1,2,26
16,800,-1433.63,RV-disorder-a,a,7,0,1,1,9
16,800,-1433.63,RV-order-t,t,2,29,6,2,39
16,800,-1433.63,RV-disorder-t,t,1,12,3,4,20
16,800,-1433.63,RV-order-c,c,3,4,17,5,29
16,800,-1433.63,RV-disorder-c,c,4,3,13,2,22
16,800,-1433.63,RV-order-g,g,1,2,1,7,11
16,800,-1433.63,RV-disorder-g,g,0,3,0,5,8
16,800,-1433.63,RV-O,O,79,18,97
16,800,-1433.63,RV-D,D,15,47,62
17,850,-1428.41,RV-order-a,a,18,5,1,2,26
17,850,-1428.41,RV-disorder-a,a,7,0,1,1,9
17,850,-1428.41,RV-order-t,t,2,29,6,2,39
17,850,-1428.41,RV-disorder-t,t,1,12,3,4,20
17,850,-1428.41,RV-order-c,c,3,4,17,5,29
17,850,-1428.41,RV-disorder-c,c,4,3,13,2,22
17,850,-1428.41,RV-order-g,g,1,2,1,7,11
17,850,-1428.41,RV-disorder-g,g,0,3,0,5,8
17,850,-1428.41,RV-O,O,79,18,97
17,850,-1428.41,RV-D,D,15,47,62
18,900,-1427.74,RV-order-a,a,18,5,1,2,26
18,900,-1427.74,RV-disorder-a,a,7,0,1,1,9
18,900,-1427.74,RV-order-t,t,2,29,6,2,39
18,900,-1427.74,RV-disorder-t,t,1,12,3,4,20
18,900,-1427.74,RV-order-c,c,3,4,17,5,29
18,900,-1427.74,RV-disorder-c,c,4,3,13,2,22
18,900,-1427.74,RV-order-g,g,1,2,1,7,11
18,900,-1427.74,RV-disorder-g,g,0,3,0,5,8
18,900,-1427.74,RV-O,O,79,18,97
18,900,-1427.74,RV-D,D,15,47,62
19,950,-1427.85,RV-order-a,a,18,5,1,2,26
19,950,-1427.85,RV-disorder-a,a,7,0,1,1,9
19,950,-1427.85,RV-order-t,t,2,29,6,2,39
19,950,-1427.85,RV-disorder-t,t,1,12,3,4,20
19,950,-1427.85,RV-order-c,c,3,4,17,5,29
19,950,-1427.85,RV-disorder-c,c,4,3,13,2,22
19,950,-1427.85,RV-order-g,g,1,2,1,7,11
19,950,-1427.85,RV-disorder-g,g,0,3,0,5,8
19,950,-1427.85,RV-O,O,79,18,97
19,950,-1427.85,RV-D,D,15,47,62
20,1000,-1427.22,RV-order-a,a,18,5,1,2,26
20,1000,-1427.22,RV-disorder-a,a,7,0,1,1,9
20,1000,-1427.22,RV-order-t,t,2,29,6,2,39
20,1000,-1427.22,RV-disorder-t,t,1,12,3,4,20
20,1000,-1427.22,RV-order-c,c,3,4,17,5,29
20,1000,-1427.22,RV-disorder-c,c,4,3,13,2,22
20,1000,-1427.22,RV-order-g,g,1,2,1,7,11
20,1000,-1427.22,RV-disorder-g,g,0,3,0,5,8
20,1000,-1427.22,RV-O,O,79,18,97
20,1000,-1427.22,RV-D,D,15,47,62
21,1050,-1395.03,RV-order-a,a,8,0,1,1,10
21,1050,-1395.03,RV-disorder-a,a,15,5,1,2,23
21,1050,-1395.03,RV-order-t,t,2,27,3,5,37
21,1050,-1395.03,RV-disorder-t,t,1,17,6,1,25
21,1050,-1395.03,RV-order-c,c,7,7,20,4,38
21,1050,-1395.03,RV-disorder-c,c,0,0,8,3,11
21,1050,-1395.03,RV-order-g,g,0,4,0,7,11
21,1050,-1395.03,RV-disorder-g,g,1,1,1,4,7
21,1050,-1395.03,RV-O,O,68,17,85
21,1050,-1395.03,RV-D,D,15,53,68
22,1100,-1391.12,RV-order-a,a,8,0,1,1,10
22,1100,-1391.12,RV-disorder-a,a,15,5,1,2,23
22,1100,-1391.12,RV-order-t,t,2,27,3,5,37
22,1100,-1391.12,RV-disorder-t,t,1,17,6,1,25
22,1100,-1391.12,RV-order-c,c,7,7,20,4,38
22,1100,-1391.12,RV-disorder-c,c,0,0,8,3,11
22,1100,-1391.12,RV-order-g,g,0,4,0,7,11
22,1100,-1391.12,RV-disorder-g,g,1,1,1,4,7
22,1100,-1391.12,RV-O,O,68,17,85
22,1100,-1391.12,RV-D,D,15,53,68
23,1150,-1388.27,RV-order-a,a,8,0,1,1,10
23,1150,-1388.27,RV-disorder-a,a,15,5,1,2,23
23,1150,-1388.27,RV-order-t,t,2,27,3,5,37
23,1150,-1388.27,RV-disorder-t,t,1,17,6,1,25
23,1150,-1388.27,RV-order-c,c,7,7,20,4,38
23,1150,-1388.27,RV-disorder-c,c,0,0,8,3,11
23,1150,-1388.27,RV-order-g,g,0,4,0,7,11
23,1150,-1388.27,RV-disorder-g,g,1,1,1,4,7
23,1150,-1388.27,RV-O,O,68,17,85
23,1150,-1388.27,RV-D,D,15,53,68
24,1200,-1387.07,RV-order-a,a,8,0,1,1,10
24,1200,-1387.07,RV-disorder-a,a,15,5,1,2,23
24,1200,-1387.07,RV-order-t,t,2,27,3,5,37
24,1200,-1387.07,RV-disorder-t,t,1,17,6,1,25
24,1200,-1387.07,RV-order-c,c,7,7,20,4,38
24,1200,-1387.07,RV-disorder-c,c,0,0,8,3,11
24,1200,-1387.07,RV-order-g,g,0,4,0,7,11
24,1200,-1387.07,RV-disorder-g,g,1,1,1,4,7
24,1200,-1387.07,RV-O,O,68,17,85
24,1200,-1387.07,RV-D,D,15,53,68
25,1250,-1383.72,RV-order-a,a,8,0,1,1,10
25,1250,-1383.72,RV-disorder-a,a,15,5,1,2,23
25,1250,-1383.72,RV-order-t,t,2,27,3,5,37
25,1250,-1383.72,RV-disorder-t,t,1,17,6,1,25
25,1250,-1383.72,RV-order-c,c,7,7,20,4,38
25,1250,-1383.72,RV-disorder-c,c,0,0,8,3,11
25,1250,-1383.72,RV-order-g,g,0,4,0,7,11
25,1250,-1383.72,RV-disorder-g,g,1,1,1,4,7
25,1250,-1383.72,RV-O,O,68,17,85
25,1250,-1383.72,RV-D,D,15,53,68
26,1300,-1321.94,RV-order-a,a,11,1,1,2,15
26,1300,-1321.94,RV-disorder-a,a,11,3,1,3,18
26,1300,-1321.94,RV-order-t,t,1,15,2,4,22
26,1300,-1321.94,RV-disorder-t,t,4,7,0,1,12
26,1300,-1321.94,RV-order-c,c,4,8,24,4,40
26,1300,-1321.94,RV-disorder-c,c,0,4,11,0,15
26,1300,-1321.94,RV-order-g,g,0,3,3,10,16
26,1300,-1321.94,RV-disorder-g,g,0,0,3,10,13
26,1300,-1321.94,RV-O,O,73,17,90
26,1300,-1321.94,RV-D,D,15,44,59
27,1350,-1320.88,RV-order-a,a,11,1,1,2,15
27,1350,-1320.88,RV-disorder-a,a,11,3,1,3,18
27,1350,-1320.88,RV-order-t,t,1,15,2,4,22
27,1350,-1320.88,RV-disorder-t,t,4,7,0,1,12
27,1350,-1320.88,RV-order-c,c,4,8,24,4,40
27,1350,-1320.88,RV-disorder-c,c,0,4,11,0,15
27,1350,-1320.88,RV-order-g,g,0,3,3,10,16
27,1350,-1320.88,RV-disorder-g,g,0,0,3,10,13
27,1350,-1320.88,RV-O,O,73,17,90
27,1350,-1320.88,RV-D,D,15,44,59
28,1400,-1319.55,RV-order-a,a,11,1,1,2,15
28,1400,-1319.55,RV-disorder-a,a,11,3,1,3,18
28,1400,-1319.55,RV-order-t,t,1,15,2,4,22
28,1400,-1319.55,RV-disorder-t,t,4,7,0,1,12
28,1400,-1319.55,RV-order-c,c,4,8,24,4,40
28,1400,-1319.55,RV-disorder-c,c,0,4,11,0,15
28,1400,-1319.55,RV-order-g,g,0,3,3,10,16
28,1400,-1319.55,RV-disorder-g,g,0,0,3,10,13
28,1400,-1319.55,RV-O,O,73,17,90
28,1400,-1319.55,RV-D,D,15,44,59
29,1450,-1315.07,RV-order-a,a,11,1,1,2,15
29,1450,-1315.07,RV-disorder-a,a,11,3,1,3,18
29,1450,-1315.07,RV-order-t,t,1,15,2,4,22
29,1450,-1315.07,RV-disorder-t,t,4,7,0,1,12
29,1450,-1315.07,RV-order-c,c,4,8,24,4,40
29,1450,-1315.07,RV-disorder-c,c,0,4,11,0,15
29,1450,-1315.07,RV-order-g,g,0,3,3,10,16
29,1450,-1315.07,RV-disorder-g,g,0,0,3,10,13
29,1450,-1315.07,RV-O,O,73,17,90
29,1450,-1315.07,RV-D,D,15,44,59
30,1500,-1313.14,RV-order-a,a,11,1,1,2,15
30,1500,-1313.14,RV-disorder-a,a,11,3,1,3,18
30,1500,-1313.14,RV-order-t,t,1,15,2,4,22
30,1500,-1313.14,RV-disorder-t,t,4,7,0,1,12
30,1500,-1313.14,RV-order-c,c,4,8,24,4,40
30,1500,-1313.14,RV-disorder-c,c,0,4,11,0,15
30,1500,-1313.14,RV-order-g,g,0,3,3,10,16
30,1500,-1313.14,RV-disorder-g,g,0,0,3,10,13
30,1500,-1313.14,RV-O,O,73,17,90
30,1500,-1313.14,RV-D,D,15,44,59
31,1550,-1248.02,RV-order-a,a,14,4,1,3,22
31,1550,-1248.02,RV-disorder-a,a,10,0,1,2,13
31,1550,-1248.02,RV-order-t,t,3,18,1,2,24
31,1550,-1248.02,RV-disorder-t,t,2,10,1,3,16
31,1550,-1248.02,RV-order-c,c,2,8,14,1,25
31,1550,-1248.02,RV-disorder-c,c,2,4,15,3,24
31,1550,-1248.02,RV-order-g,g,0,0,3,7,10
31,1550,-1248.02,RV-disorder-g,g,0,3,3,6,12
31,1550,-1248.02,RV-O,O,64,14,78
31,1550,-1248.02,RV-D,D,15,46,61
32,1600,-1244.68,RV-order-a,a,14,4,1,3,22
32,1600,-1244.68,RV-disorder-a,a,10,0,1,2,13
32,1600,-1244.68,RV-order-t,t,3,18,1,2,24
32,1600,-1244.68,RV-disorder-t,t,2,10,1,3,16
32,1600,-1244.68,RV-order-c,c,2,8,14,1,25
32,1600,-1244.68,RV-disorder-c,c,2,4,15,3,24
32,1600,-1244.68,RV-order-g,g,0,0,3,7,10
32,1600,-1244.68,RV-disorder-g,g,0,3,3,6,12
32,1600,-1244.68,RV-O,O,64,14,78
32,1600,-1244.68,RV-D,D,15,46,61
33,1650,-1245.3,RV-order-a,a,14,4,1,3,22
33,1650,-1245.3,RV-disorder-a,a,10,0,1,2,13
33,1650,-1245.3,RV-order-t,t,3,18,1,2,24
33,1650,-1245.3,RV-disorder-t,t,2,10,1,3,16
33,1650,-1245.3,RV-order-c,c,2,8,14,1,25
33,1650,-1245.3,RV-disorder-c,c,2,4,15,3,24
33,1650,-1245.3,RV-order-g,g,0,0,3,7,10
33,1650,-1245.3,RV-disorder-g,g,0,3,3,6,12
33,1650,-1245.3,RV-O,O,64,14,78
33,1650,-1245.3,RV-D,D,15,46,61
34,1700,-1242.61,RV-order-a,a,14,4,1,3,22
34,1700,-1242.61,RV-disorder-a,a,10,0,1,2,13
34,1700,-1242.61,RV-order-t,t,3,18,1,2,24
34,1700,-1242.61,RV-disorder-t,t,2,10,1,3,16
34,1700,-1242.61,RV-order-c,c,2,8,14,1,25
34,1700,-1242.61,RV-disorder-c,c,2,4,15,3,24
34,1700,-1242.61,RV-order-g,g,0,0,3,7,10
34,1700,-1242.61,RV-disorder-g,g,0,3,3,6,12
34,1700,-1242.61,RV-O,O,64,14,78
34,1700,-1242.61,RV-D,D,15,46,61
35,1750,-1239.61,RV-order-a,a,14,4,1,3,22
35,1750,-1239.61,RV-disorder-a,a,10,0,1,2,13
35,1750,-1239.61,RV-order-t,t,3,18,1,2,24
35,1750,-1239.61,RV-disorder-t,t,2,10,1,3,16
35,1750,-1239.61,RV-order-c,c,2,8,14,1,25
35,1750,-1239.61,RV-disorder-c,c,2,4,15,3,24
35,1750,-1239.61,RV-order-g,g,0,0,3,7,10
35,1750,-1239.61,RV-disorder-g,g,0,3,3,6,12
35,1750,-1239.61,RV-O,O,64,14,78
35,1750,-1239.61,RV-D,D,15,46,61
36,1800,-1278.98,RV-order-a,a,9,3,1,2,15
36,1800,-1278.98,RV-disorder-a,a,8,0,3,0,11
36,1800,-1278.98,RV-order-t,t,5,32,8,3,48
36,1800,-1278.98,RV-disorder-t,t,0,16,5,4,25
36,1800,-1278.98,RV-order-c,c,2,1,9,3,15
36,1800,-1278.98,RV-disorder-c,c,4,1,11,2,18
36,1800,-1278.98,RV-order-g,g,1,1,1,5,8
36,1800,-1278.98,RV-disorder-g,g,1,4,0,12,17
36,1800,-1278.98,RV-O,O,63,14,77
36,1800,-1278.98,RV-D,D,15,45,60
37,1850,-1278.3,RV-order-a,a,9,3,1,2,15
37,1850,-1278.3,RV-disorder-a,a,8,0,3,0,11
37,1850,-1278.3,RV-order-t,t,5,32,8,3,48
37,1850,-1278.3,RV-disorder-t,t,0,16,5,4,25
37,1850,-1278.3,RV-order-c,c,2,1,9,3,15
37,1850,-1278.3,RV-disorder-c,c,4,1,11,2,18
37,1850,-1278.3,RV-order-g,g,1,1,1,5,8
37,1850,-1278.3,RV-disorder-g,g,1,4,0,12,17
37,1850,-1278.3,RV-O,O,63,14,77
37,1850,-1278.3,RV-D,D,15,45,60
38,1900,-1278.75,RV-order-a,a,9,3,1,2,15
38,1900,-1278.75,RV-disorder-a,a,8,0,3,0,11
38,1900,-1278.75,RV-order-t,t,5,32,8,3,48
38,1900,-1278.75,RV-disorder-t,t,0,16,5,4,25
38,1900,-1278.75,RV-order-c,c,2,1,9,3,15
38,1900,-1278.75,RV-disorder-c,c,4,1,11,2,18
38,1900,-1278.75,RV-order-g,g,1,1,1,5,8
38,1900,-1278.75,RV-disorder-g,g,1,4,0,12,17
38,1900,-1278.75,RV-O,O,63,14,77
38,1900,-1278.75,RV-D,D,15,45,60
39,1950,-1278.59,RV-order-a,a,9,3,1,2,15
39,1950,-1278.59,RV-disorder-a,a,8,0,3,0,11
39,1950,-1278.59,RV-order-t,t,5,32,8,3,48
39,1950,-1278.59,RV-disorder-t,t,0,16,5,4,25
39,1950,-1278.59,RV-order-c,c,2,1,9,3,15
39,1950,-1278.59,RV-disorder-c,c,4,1,11,2,18
39,1950,-1278.59,RV-order-g,g,1,1,1,5,8
39,1950,-1278.59,RV-disorder-g,g,1,4,0,12,17
39,1950,-1278.59,RV-O,O,63,14,77
39,1950,-1278.59,RV-D,D,15,45,60
40,2000,-1278.05,RV-order-a,a,9,3,1,2,15
40,2000,-1278.05,RV-disorder-a,a,8,0,3,0,11
40,2000,-1278.05,RV-order-t,t,5,32,8,3,48
40,2000,-1278.05,RV-disorder-t,t,0,16,5,4,25
40,2000,-1278.05,RV-order-c,c,2,1,9,3,15
40,2000,-1278.05,RV-disorder-c,c,4,1,11,2,18
40,2000,-1278.05,RV-order-g,g,1,1,1,5,8
40,2000,-1278.05,RV-disorder-g,g,1,4,0,12,17
40,2000,-1278.05,RV-O,O,63,14,77
40,2000,-1278.05,RV-D,D,15,45,60
