I,GEN,LogL,RateVector,State,a,t,c,g,Total
0,0,-1654.25,RV-order-a,a,15,3,4,1,23
0,0,-1654.25,RV-disorder-a,a,4,0,2,0,6
0,0,-1654.25,RV-order-t,t,3,20,5,3,31
0,0,-1654.25,RV-disorder-t,t,2,14,1,3,20
0,0,-1654.25,RV-order-c,c,1,5,18,4,28
0,0,-1654.25,RV-disorder-c,c,1,5,10,3,19
0,0,-1654.25,RV-order-g,g,5,4,1,12,22
0,0,-1654.25,RV-disorder-g,g,0,1,1,5,7
0,0,-1654.25,RV-O,O,88,17,105
0,0,-1654.25,RV-D,D,21,29,50
1,50,-1569.26,RV-order-a,a,17,3,2,0,22
1,50,-1569.26,RV-disorder-a,a,11,0,4,1,16
1,50,-1569.26,RV-order-t,t,3,17,2,4,26
1,50,-1569.26,RV-disorder-t,t,2,15,4,2,23
1,50,-1569.26,RV-order-c,c,1,8,16,2,27
1,50,-1569.26,RV-disorder-c,c,1,2,11,5,19
1,50,-1569.26,RV-order-g,g,1,2,2,4,9
1,50,-1569.26,RV-disorder-g,g,4,3,0,9,16
1,50,-1569.26,RV-O,O,62,18,80
1,50,-1569.26,RV-D,D,19,49,68
2,100,-1525.7,RV-order-a,a,17,3,2,0,22
2,100,-1525.7,RV-disorder-a,a,11,0,4,1,16
2,100,-1525.7,RV-order-t,t,3,17,2,4,26
2,100,-1525.7,RV-disorder-t,t,2,15,4,2,23
2,100,-1525.7,RV-order-c,c,1,8,16,2,27
2,100,-1525.7,RV-disorder-c,c,1,2,11,5,19
2,100,-1525.7,RV-order-g,g,1,2,2,4,9
2,100,-1525.7,RV-disorder-g,g,4,3,0,9,16
2,100,-1525.7,RV-O,O,62,18,80
2,100,-1525.7,RV-D,D,19,49,68
3,150,-1501.08,RV-order-a,a,17,3,2,0,22
3,150,-1501.08,RV-disorder-a,a,11,0,4,1,16
3,150,-1501.08,RV-order-t,t,3,17,2,4,26
3,150,-1501.08,RV-disorder-t,t,2,15,4,2,23
3,150,-1501.08,RV-order-c,c,1,8,16,2,27
3,150,-1501.08,RV-disorder-c,c,1,2,11,5,19
3,150,-1501.08,RV-order-g,g,1,2,2,4,9
3,150,-1501.08,RV-disorder-g,g,4,3,0,9,16
3,150,-1501.08,RV-O,O,62,18,80
3,150,-1501.08,RV-D,D,19,49,68
4,200,-1473.29,RV-order-a,a,17,3,2,0,22
4,200,-1473.29,RV-disorder-a,a,11,0,4,1,16
4,200,-1473.29,RV-order-t,t,3,17,2,4,26
4,200,-1473.29,RV-disorder-t,t,2,15,4,2,23
4,200,-1473.29,RV-order-c,c,1,8,16,2,27
4,200,-1473.29,RV-disorder-c,c,1,2,11,5,19
4,200,-1473.29,RV-order-g,g,1,2,2,4,9
4,200,-1473.29,RV-disorder-g,g,4,3,0,9,16
4,200,-1473.29,RV-O,O,62,18,80
4,200,-1473.29,RV-D,D,19,49,68
5,250,-1476.33,RV-order-a,a,7,2,0,3,12
5,250,-1476.33,RV-disorder-a,a,16,2,4,2,24
5,250,-1476.33,RV-order-t,t,4,32,7,5,48
5,250,-1476.33,RV-disorder-t,t,0,9,0,2,11
5,250,-1476.33,RV-order-c,c,1,3,4,1,9
5,250,-1476.33,RV-disorder-c,c,2,3,10,2,17
5,250,-1476.33,RV-order-g,g,2,1,3,9,15
5,250,-1476.33,RV-disorder-g,g,1,6,3,13,23
5,250,-1476.33,RV-O,O,63,18,81
5,250,-1476.33,RV-D,D,19,54,73
6,300,-1462.83,RV-order-a,a,7,2,0,3,12
6,300,-1462.83,RV-disorder-a,a,16,2,4,2,24
6,300,-1462.83,RV-order-t,t,4,32,7,5,48
6,300,-1462.83,RV-disorder-t,t,0,9,0,2,11
6,300,-1462.83,RV-order-c,c,1,3,4,1,9
6,300,-1462.83,RV-disorder-c,c,2,3,10,2,17
6,300,-1462.83,RV-order-g,g,2,1,3,9,15
6,300,-1462.83,RV-disorder-g,g,1,6,3,13,23
6,300,-1462.83,RV-O,O,63,18,81
6,300,-1462.83,RV-D,D,19,54,73
7,350,-1455.2,RV-order-a,a,7,2,0,3,12
7,350,-1455.2,RV-disorder-a,a,16,2,4,2,24
7,350,-1455.2,RV-order-t,t,4,32,7,5,48
7,350,-1455.2,RV-disorder-t,t,0,9,0,2,11
7,350,-1455.2,RV-order-c,c,1,3,4,1,9
7,350,-1455.2,RV-disorder-c,c,2,3,10,2,17
7,350,-1455.2,RV-order-g,g,2,1,3,9,15
7,350,-1455.2,RV-disorder-g,g,1,6,3,13,23
7,350,-1455.2,RV-O,O,63,18,81
7,350,-1455.2,RV-D,D,19,54,73
8,400,-1446.2,RV-order-a,a,7,2,0,3,12
8,400,-1446.2,RV-disorder-a,a,16,2,4,2,24
8,400,-1446.2,RV-order-t,t,4,32,7,5,48
8,400,-1446.2,RV-disorder-t,t,0,9,0,2,11
8,400,-1446.2,RV-order-c,c,1,3,4,1,9
8,400,-1446.2,RV-disorder-c,c,2,3,10,2,17
8,400,-1446.2,RV-order-g,g,2,1,3,9,15
8,400,-1446.2,RV-disorder-g,g,1,6,3,13,23
8,400,-1446.2,RV-O,O,63,18,81
8,400,-1446.2,RV-D,D,19,54,73
9,450,-1439.26,RV-order-a,a,7,2,0,3,12
9,450,-1439.26,RV-disorder-a,a,16,2,4,2,24
9,450,-1439.26,RV-order-t,t,4,32,7,5,48
9,450,-1439.26,RV-disorder-t,t,0,9,0,2,11
9,450,-1439.26,RV-order-c,c,1,3,4,1,9
9,450,-1439.26,RV-disorder-c,c,2,3,10,2,17
9,450,-1439.26,RV-order-g,g,2,1,3,9,15
9,450,-1439.26,RV-disorder-g,g,1,6,3,13,23
9,450,-1439.26,RV-O,O,63,18,81
9,450,-1439.26,RV-D,D,19,54,73
10,500,-1434.92,RV-order-a,a,7,2,0,3,12
10,500,-1434.92,RV-disorder-a,a,16,2,4,2,24
10,500,-1434.92,RV-order-t,t,4,32,7,5,48
10,500,-1434.92,RV-disorder-t,t,0,9,0,2,11
10,500,-1434.92,RV-order-c,c,1,3,4,1,9
10,500,-1434.92,RV-disorder-c,c,2,3,10,2,17
10,500,-1434.92,RV-order-g,g,2,1,3,9,15
10,500,-1434.92,RV-disorder-g,g,1,6,3,13,23
10,500,-1434.92,RV-O,O,63,18,81
10,500,-1434.92,RV-D,D,19,54,73
11,550,-1432.66,RV-order-a,a,10,3,3,4,20
11,550,-1432.66,RV-disorder-a,a,9,1,1,1,12
11,550,-1432.66,RV-order-t,t,3,22,6,4,35
11,550,-1432.66,RV-disorder-t,t,1,18,1,3,23
11,550,-1432.66,RV-order-c,c,2,5,12,3,22
11,550,-1432.66,RV-disorder-c,c,1,1,7,0,9
11,550,-1432.66,RV-order-g,g,2,5,3,3,13
11,550,-1432.66,RV-disorder-g,g,1,2,3,11,17
11,550,-1432.66,RV-O,O,79,23,102
11,550,-1432.66,RV-D,D,14,46,60
12,600,-1429.05,RV-order-a,a,10,3,3,4,20
12,600,-1429.05,RV-disorder-a,a,9,1,1,1,12
12,600,-1429.05,RV-order-t,t,3,22,6,4,35
12,600,-1429.05,RV-disorder-t,t,1,18,1,3,23
12,600,-1429.05,RV-order-c,c,2,5,12,3,22
12,600,-1429.05,RV-disorder-c,c,1,1,7,0,9
12,600,-1429.05,RV-order-g,g,2,5,3,3,13
12,600,-1429.05,RV-disorder-g,g,1,2,3,11,17
12,600,-1429.05,RV-O,O,79,23,102
12,600,-1429.05,RV-D,D,14,46,60
13,650,-1428.87,RV-order-a,a,10,3,3,4,20
13,650,-1428.87,RV-disorder-a,a,9,1,1,1,12
13,650,-1428.87,RV-order-t,t,3,22,6,4,35
13,650,-1428.87,RV-disorder-t,t,1,18,1,3,23
13,650,-1428.87,RV-order-c,c,2,5,12,3,22
13,650,-1428.87,RV-disorder-c,c,1,1,7,0,9
13,650,-1428.87,RV-order-g,g,2,5,3,3,13
13,650,-1428.87,RV-disorder-g,g,1,2,3,11,17
13,650,-1428.87,RV-O,O,79,23,102
13,650,-1428.87,RV-D,D,14,46,60
14,700,-1427.11,RV-order-a,a,10,3,3,4,20
14,700,-1427.11,RV-disorder-a,a,9,1,1,1,12
14,700,-1427.11,RV-order-t,t,3,22,6,4,35
14,700,-1427.11,RV-disorder-t,t,1,18,1,3,23
14,700,-1427.11,RV-order-c,c,2,5,12,3,22
14,700,-1427.11,RV-disorder-c,c,1,1,7,0,9
14,700,-1427.11,RV-order-g,g,2,5,3,3,13
14,700,-1427.11,RV-disorder-g,g,1,2,3,11,17
14,700,-1427.11,RV-O,O,79,23,102
14,700,-1427.11,RV-D,D,14,46,60
15,750,-1421.03,RV-order-a,a,10,3,3,4,20
15,750,-1421.03,RV-disorder-a,a,9,1,1,1,12
15,750,-1421.03,RV-order-t,t,3,22,6,4,35
15,750,-1421.03,RV-disorder-t,t,1,18,1,3,23
15,750,-1421.03,RV-order-c,c,2,5,12,3,22
15,750,-1421.03,RV-disorder-c,c,1,1,7,0,9
15,750,-1421.03,RV-order-g,g,2,5,3,3,13
15,750,-1421.03,RV-disorder-g,g,1,2,3,11,17
15,750,-1421.03,RV-O,O,79,23,102
15,750,-1421.03,RV-D,D,14,46,60
16,800,-1354.02,RV-order-a,a,10,5,3,2,20
16,800,-1354.02,RV-disorder-a,a,9,1,2,1,13
16,800,-1354.02,RV-order-t,t,2,16,7,2,27
16,800,-1354.02,RV-disorder-t,t,1,13,1,3,18
16,800,-1354.02,RV-order-c,c,1,6,13,3,23
16,800,-1354.02,RV-disorder-c,c,1,2,9,1,13
16,800,-1354.02,RV-order-g,g,4,2,0,7,13
16,800,-1354.02,RV-disorder-g,g,3,3,4,12,22
16,800,-1354.02,RV-O,O,65,23,88
16,800,-1354.02,RV-D,D,14,43,57
17,850,-1348.59,RV-order-a,a,10,5,3,2,20
17,850,-1348.59,RV-disorder-a,a,9,1,2,1,13
17,850,-1348.59,RV-order-t,t,2,16,7,2,27
17,850,-1348.59,RV-disorder-t,t,1,13,1,3,18
17,850,-1348.59,RV-order-c,c,1,6,13,3,23
17,850,-1348.59,RV-disorder-c,c,1,2,9,1,13
17,850,-1348.59,RV-order-g,g,4,2,0,7,13
17,850,-1348.59,RV-disorder-g,g,3,3,4,12,22
17,850,-1348.59,RV-O,O,65,23,88
17,850,-1348.59,RV-D,D,14,43,57
18,900,-1347.09,RV-order-a,a,10,5,3,2,20
18,900,-1347.09,RV-disorder-a,a,9,1,2,1,13
18,900,-1347.09,RV-order-t,t,2,16,7,2,27
18,900,-1347.09,RV-disorder-t,t,1,13,1,3,18
18,900,-1347.09,RV-order-c,c,1,6,13,3,23
18,900,-1347.09,RV-disorder-c,c,1,2,9,1,13
18,900,-1347.09,RV-order-g,g,4,2,0,7,13
18,900,-1347.09,RV-disorder-g,g,3,3,4,12,22
18,900,-1347.09,RV-O,O,65,23,88
18,900,-1347.09,RV-D,D,14,43,57
19,950,-1346.57,RV-order-a,a,10,5,3,2,20
19,950,-1346.57,RV-disorder-a,a,9,1,2,1,13
19,950,-1346.57,RV-order-t,t,2,16,7,2,27
19,950,-1346.57,RV-disorder-t,t,1,13,1,3,18
19,950,-1346.57,RV-order-c,c,1,6,13,3,23
19,950,-1346.57,RV-disorder-c,c,1,2,9,1,13
19,950,-1346.57,RV-order-g,g,4,2,0,7,13
19,950,-1346.57,RV-disorder-g,g,3,3,4,12,22
19,950,-1346.57,RV-O,O,65,23,88
19,950,-1346.57,RV-D,D,14,43,57
20,1000,-1346.27,RV-order-a,a,10,5,3,2,20
20,1000,-1346.27,RV-disorder-a,a,9,1,2,1,13
20,1000,-1346.27,RV-order-t,t,2,16,7,2,27
20,1000,-1346.27,RV-disorder-t,t,1,13,1,3,18
20,1000,-1346.27,RV-order-c,c,1,6,13,3,23
20,1000,-1346.27,RV-disorder-c,c,1,2,9,1,13
20,1000,-1346.27,RV-order-g,g,4,2,0,7,13
20,1000,-1346.27,RV-disorder-g,g,3,3,4,12,22
20,1000,-1346.27,RV-O,O,65,23,88
20,1000,-1346.27,RV-D,D,14,43,57
21,1050,-1415.44,RV-order-a,a,9,5,1,2,17
21,1050,-1415.44,RV-disorder-a,a,8,1,4,1,14
21,1050,-1415.44,RV-order-t,t,2,24,5,3,34
21,1050,-1415.44,RV-disorder-t,t,1,16,3,2,22
21,1050,-1415.44,RV-order-c,c,0,6,11,3,20
21,1050,-1415.44,RV-disorder-c,c,2,2,8,1,13
21,1050,-1415.44,RV-order-g,g,1,3,0,8,12
21,1050,-1415.44,RV-disorder-g,g,6,2,4,13,25
21,1050,-1415.44,RV-O,O,57,21,78
21,1050,-1415.44,RV-D,D,25,45,70
22,1100,-1416.91,RV-order-a,a,9,5,1,2,17
22,1100,-1416.91,RV-disorder-a,a,8,1,4,1,14
22,1100,-1416.91,RV-order-t,t,2,24,5,3,34
22,1100,-1416.91,RV-disorder-t,t,1,16,3,2,22
22,1100,-1416.91,RV-order-c,c,0,6,11,3,20
22,1100,-1416.91,RV-disorder-c,c,2,2,8,1,13
22,1100,-1416.91,RV-order-g,g,1,3,0,8,12
22,1100,-1416.91,RV-disorder-g,g,6,2,4,13,25
22,1100,-1416.91,RV-O,O,57,21,78
22,1100,-1416.91,RV-D,D,25,45,70
23,1150,-1411.69,RV-order-a,a,9,5,1,2,17
23,1150,-1411.69,RV-disorder-a,a,8,1,4,1,14
23,1150,-1411.69,RV-order-t,t,2,24,5,3,34
23,1150,-1411.69,RV-disorder-t,t,1,16,3,2,22
23,1150,-1411.69,RV-order-c,c,0,6,11,3,20
23,1150,-1411.69,RV-disorder-c,c,2,2,8,1,13
23,1150,-1411.69,RV-order-g,g,1,3,0,8,12
23,1150,-1411.69,RV-disorder-g,g,6,2,4,13,25
23,1150,-1411.69,RV-O,O,57,21,78
23,1150,-1411.69,RV-D,D,25,45,70
24,1200,-1406.1,RV-order-a,a,9,5,1,2,17
24,1200,-1406.1,RV-disorder-a,a,8,1,4,1,14
24,1200,-1406.1,RV-order-t,t,2,24,5,3,34
24,1200,-1406.1,RV-disorder-t,t,1,16,3,2,22
24,1200,-1406.1,RV-order-c,c,0,6,11,3,20
24,1200,-1406.1,RV-disorder-c,c,2,2,8,1,13
24,1200,-1406.1,RV-order-g,g,1,3,0,8,12
24,1200,-1406.1,RV-disorder-g,g,6,2,4,13,25
24,1200,-1406.1,RV-O,O,57,21,78
24,1200,-1406.1,RV-D,D,25,45,70
25,1250,-1399.65,RV-order-a,a,9,5,1,2,17
25,1250,-1399.65,RV-disorder-a,a,8,1,4,1,14
25,1250,-1399.65,RV-order-t,t,2,24,5,3,34
25,1250,-1399.65,RV-disorder-t,t,1,16,3,2,22
25,1250,-1399.65,RV-order-c,c,0,6,11,3,20
25,1250,-1399.65,RV-disorder-c,c,2,2,8,1,13
25,1250,-1399.65,RV-order-g,g,1,3,0,8,12
25,1250,-1399.65,RV-disorder-g,g,6,2,4,13,25
25,1250,-1399.65,RV-O,O,57,21,78
25,1250,-1399.65,RV-D,D,25,45,70
26,1300,-1400.79,RV-order-a,a,10,2,3,0,15
26,1300,-1400.79,RV-disorder-a,a,17,1,3,4,25
26,1300,-1400.79,RV-order-t,t,4,18,3,5,30
26,1300,-1400.79,RV-disorder-t,t,2,18,2,4,26
26,1300,-1400.79,RV-order-c,c,3,3,10,0,16
26,1300,-1400.79,RV-disorder-c,c,2,3,12,3,20
26,1300,-1400.79,RV-order-g,g,1,2,3,5,11
26,1300,-1400.79,RV-disorder-g,g,1,2,1,6,10
26,1300,-1400.79,RV-O,O,55,21,76
26,1300,-1400.79,RV-D,D,25,54,79
27,1350,-1400.47,RV-order-a,a,10,2,3,0,15
27,1350,-1400.47,RV-disorder-a,a,17,1,3,4,25
27,1350,-1400.47,RV-order-t,t,4,18,3,5,30
27,1350,-1400.47,RV-disorder-t,t,2,18,2,4,26
27,1350,-1400.47,RV-order-c,c,3,3,10,0,16
27,1350,-1400.47,RV-disorder-c,c,2,3,12,3,20
27,1350,-1400.47,RV-order-g,g,1,2,3,5,11
27,1350,-1400.47,RV-disorder-g,g,1,2,1,6,10
27,1350,-1400.47,RV-O,O,55,21,76
27,1350,-1400.47,RV-D,D,25,54,79
28,1400,-1398.75,RV-order-a,a,10,2,3,0,15
28,1400,-1398.75,RV-disorder-a,a,17,1,3,4,25
28,1400,-1398.75,RV-order-t,t,4,18,3,5,30
28,1400,-1398.75,RV-disorder-t,t,2,18,2,4,26
28,1400,-1398.75,RV-order-c,c,3,3,10,0,16
28,1400,-1398.75,RV-disorder-c,c,2,3,12,3,20
28,1400,-1398.75,RV-order-g,g,1,2,3,5,11
28,1400,-1398.75,RV-disorder-g,g,1,2,1,6,10
28,1400,-1398.75,RV-O,O,55,21,76
28,1400,-1398.75,RV-D,D,25,54,79
29,1450,-1399.43,RV-order-a,a,10,2,3,0,15
29,1450,-1399.43,RV-disorder-a,a,17,1,3,4,25
29,1450,-1399.43,RV-order-t,t,4,18,3,5,30
29,1450,-1399.43,RV-disorder-t,t,2,18,2,4,26
29,1450,-1399.43,RV-order-c,c,3,3,10,0,16
29,1450,-1399.43,RV-disorder-c,c,2,3,12,3,20
29,1450,-1399.43,RV-order-g,g,1,2,3,5,11
29,1450,-1399.43,RV-disorder-g,g,1,2,1,6,10
29,1450,-1399.43,RV-O,O,55,21,76
29,1450,-1399.43,RV-D,D,25,54,79
30,1500,-1398.5,RV-order-a,a,10,2,3,0,15
30,1500,-1398.5,RV-disorder-a,a,17,1,3,4,25
30,1500,-1398.5,RV-order-t,t,4,18,3,5,30
30,1500,-1398.5,RV-disorder-t,t,2,18,2,4,26
30,1500,-1398.5,RV-order-c,c,3,3,10,0,16
30,1500,-1398.5,RV-disorder-c,c,2,3,12,3,20
30,1500,-1398.5,RV-order-g,g,1,2,3,5,11
30,1500,-1398.5,RV-disorder-g,g,1,2,1,6,10
30,1500,-1398.5,RV-O,O,55,21,76
30,1500,-1398.5,RV-D,D,25,54,79
31,1550,-1292.31,RV-order-a,a,10,2,4,0,16
31,1550,-1292.31,RV-disorder-a,a,4,1,2,4,11
31,1550,-1292.31,RV-order-t,t,4,20,4,6,34
31,1550,-1292.31,RV-disorder-t,t,2,16,1,3,22
31,1550,-1292.31,RV-order-c,c,3,4,11,1,19
31,1550,-1292.31,RV-disorder-c,c,2,2,9,2,15
31,1550,-1292.31,RV-order-g,g,1,3,2,5,11
31,1550,-1292.31,RV-disorder-g,g,1,1,2,7,11
31,1550,-1292.31,RV-O,O,68,22,90
31,1550,-1292.31,RV-D,D,12,50,62
32,1600,-1292.57,RV-order-a,a,10,2,4,0,16
32,1600,-1292.57,RV-disorder-a,a,4,1,2,4,11
32,1600,-1292.57,RV-order-t,t,4,20,4,6,34
32,1600,-1292.57,RV-disorder-t,t,2,16,1,3,22
32,1600,-1292.57,RV-order-c,c,3,4,11,1,19
32,1600,-1292.57,RV-disorder-c,c,2,2,9,2,15
32,1600,-1292.57,RV-order-g,g,1,3,2,5,11
32,1600,-1292.57,RV-disorder-g,g,1,1,2,7,11
32,1600,-1292.57,RV-O,O,68,22,90
32,1600,-1292.57,RV-D,D,12,50,62
33,1650,-1291.95,RV-order-a,a,10,2,4,0,16
33,1650,-1291.95,RV-disorder-a,a,4,1,2,4,11
33,1650,-1291.95,RV-order-t,t,4,20,4,6,34
33,1650,-1291.95,RV-disorder-t,t,2,16,1,3,22
33,1650,-1291.95,RV-order-c,c,3,4,11,1,19
33,1650,-1291.95,RV-disorder-c,c,2,2,9,2,15
33,1650,-1291.95,RV-order-g,g,1,3,2,5,11
33,1650,-1291.95,RV-disorder-g,g,1,1,2,7,11
33,1650,-1291.95,RV-O,O,68,22,90
33,1650,-1291.95,RV-D,D,12,50,62
34,1700,-1289.74,RV-order-a,a,10,2,4,0,16
34,1700,-1289.74,RV-disorder-a,a,4,1,2,4,11
34,1700,-1289.74,RV-order-t,t,4,20,4,6,34
34,1700,-1289.74,RV-disorder-t,t,2,16,1,3,22
34,1700,-1289.74,RV-order-c,c,3,4,11,1,19
34,1700,-1289.74,RV-disorder-c,c,2,2,9,2,15
34,1700,-1289.74,RV-order-g,g,1,3,2,5,11
34,1700,-1289.74,RV-disorder-g,g,1,1,2,7,11
34,1700,-1289.74,RV-O,O,68,22,90
34,1700,-1289.74,RV-D,D,12,50,62
35,1750,-1289.07,RV-order-a,a,10,2,4,0,16
35,1750,-1289.07,RV-disorder-a,a,4,1,2,4,11
35,1750,-1289.07,RV-order-t,t,4,20,4,6,34
35,1750,-1289.07,RV-disorder-t,t,2,16,1,3,22
35,1750,-1289.07,RV-order-c,c,3,4,11,1,19
35,1750,-1289.07,RV-disorder-c,c,2,2,9,2,15
35,1750,-1289.07,RV-order-g,g,1,3,2,5,11
35,1750,-1289.07,RV-disorder-g,g,1,1,2,7,11
35,1750,-1289.07,RV-O,O,68,22,90
35,1750,-1289.07,RV-D,D,12,50,62
36,1800,-1397.36,RV-order-a,a,13,3,3,2,21
36,1800,-1397.36,RV-disorder-a,a,11,0,3,1,15
36,1800,-1397.36,RV-order-t,t,7,15,2,5,29
36,1800,-1397.36,RV-disorder-t,t,1,19,2,2,24
36,1800,-1397.36,RV-order-c,c,1,9,12,1,23
36,1800,-1397.36,RV-disorder-c,c,1,2,10,3,16
36,1800,-1397.36,RV-order-g,g,2,5,2,6,15
36,1800,-1397.36,RV-disorder-g,g,3,1,4,9,17
36,1800,-1397.36,RV-O,O,66,22,88
36,1800,-1397.36,RV-D,D,12,57,69
37,1850,-1393.02,RV-order-a,a,13,3,3,2,21
37,1850,-1393.02,RV-disorder-a,a,11,0,3,1,15
37,1850,-1393.02,RV-order-t,t,7,15,2,5,29
37,1850,-1393.02,RV-disorder-t,t,1,19,2,2,24
37,1850,-1393.02,RV-order-c,c,1,9,12,1,23
37,1850,-1393.02,RV-disorder-c,c,1,2,10,3,16
37,1850,-1393.02,RV-order-g,g,2,5,2,6,15
37,1850,-1393.02,RV-disorder-g,g,3,1,4,9,17
37,1850,-1393.02,RV-O,O,66,22,88
37,1850,-1393.02,RV-D,D,12,57,69
38,1900,-1393.34,RV-order-a,a,13,3,3,2,21
38,1900,-1393.34,RV-disorder-a,a,11,0,3,1,15
38,1900,-1393.34,RV-order-t,t,7,15,2,5,29
38,1900,-1393.34,RV-disorder-t,t,1,19,2,2,24
38,1900,-1393.34,RV-order-c,c,1,9,12,1,23
38,1900,-1393.34,RV-disorder-c,c,1,2,10,3,16
38,1900,-1393.34,RV-order-g,g,2,5,2,6,15
38,1900,-1393.34,RV-disorder-g,g,3,1,4,9,17
38,1900,-1393.34,RV-O,O,66,22,88
38,1900,-1393.34,RV-D,D,12,57,69
39,1950,-1391.36,RV-order-a,a,13,3,3,2,21
39,1950,-1391.36,RV-disorder-a,a,11,0,3,1,15
39,1950,-1391.36,RV-order-t,t,7,15,2,5,29
39,1950,-1391.36,RV-disorder-t,t,1,19,2,2,24
39,1950,-1391.36,RV-order-c,c,1,9,12,1,23
39,1950,-1391.36,RV-disorder-c,c,1,2,10,3,16
39,1950,-1391.36,RV-order-g,g,2,5,2,6,15
39,1950,-1391.36,RV-disorder-g,g,3,1,4,9,17
39,1950,-1391.36,RV-O,O,66,22,88
39,1950,-1391.36,RV-D,D,12,57,69
40,2000,-1391.89,RV-order-a,a,13,3,3,2,21
40,2000,-1391.89,RV-disorder-a,a,11,0,3,1,15
40,2000,-1391.89,RV-order-t,t,7,15,2,5,29
40,2000,-1391.89,RV-disorder-t,t,1,19,2,2,24
40,2000,-1391.89,RV-order-c,c,1,9,12,1,23
40,2000,-1391.89,RV-disorder-c,c,1,2,10,3,16
40,2000,-1391.89,RV-order-g,g,2,5,2,6,15
40,2000,-1391.89,RV-disorder-g,g,3,1,4,9,17
40,2000,-1391.89,RV-O,O,66,22,88
40,2000,-1391.89,RV-D,D,12,57,69
