I,GEN,LogL,RateVector,State,a,t,c,g,Total
0,0,-728.494,RV-a,a,16,6,3,5,30
0,0,-728.494,RV-t,t,4,20,7,5,36
0,0,-728.494,RV-c,c,4,6,12,3,25
0,0,-728.494,RV-g,g,3,9,5,10,27
1,100,-607.879,RV-a,a,22,5,4,6,37
1,100,-607.879,RV-t,t,4,20,4,6,34
1,100,-607.879,RV-c,c,1,7,17,2,27
1,100,-607.879,RV-g,g,1,2,4,9,16
2,200,-597.744,RV-a,a,22,5,4,6,37
2,200,-597.744,RV-t,t,4,20,4,6,34
2,200,-597.744,RV-c,c,1,7,17,2,27
2,200,-597.744,RV-g,g,1,2,4,9,16
3,300,-567.372,RV-a,a,15,4,4,6,29
3,300,-567.372,RV-t,t,5,26,1,6,38
3,300,-567.372,RV-c,c,1,10,17,3,31
3,300,-567.372,RV-g,g,1,2,3,3,9
4,400,-565.144,RV-a,a,15,4,4,6,29
4,400,-565.144,RV-t,t,5,26,1,6,38
4,400,-565.144,RV-c,c,1,10,17,3,31
4,400,-565.144,RV-g,g,1,2,3,3,9
5,500,-548.941,RV-a,a,12,4,4,4,24
5,500,-548.941,RV-t,t,4,21,3,6,34
5,500,-548.941,RV-c,c,1,8,17,4,30
5,500,-548.941,RV-g,g,2,3,3,9,17
6,600,-544.829,RV-a,a,12,4,4,4,24
6,600,-544.829,RV-t,t,4,21,3,6,34
6,600,-544.829,RV-c,c,1,8,17,4,30
6,600,-544.829,RV-g,g,2,3,3,9,17
7,700,-564.147,RV-a,a,18,4,4,3,29
7,700,-564.147,RV-t,t,3,25,4,7,39
7,700,-564.147,RV-c,c,1,7,12,2,22
7,700,-564.147,RV-g,g,3,4,4,11,22
8,800,-562.496,RV-a,a,18,4,4,3,29
8,800,-562.496,RV-t,t,3,25,4,7,39
8,800,-562.496,RV-c,c,1,7,12,2,22
8,800,-562.496,RV-g,g,3,4,4,11,22
9,900,-542.422,RV-a,a,12,3,4,4,23
9,900,-542.422,RV-t,t,7,25,4,6,42
9,900,-542.422,RV-c,c,1,6,11,2,20
9,900,-542.422,RV-g,g,1,4,6,8,19
10,1000,-539.992,RV-a,a,12,3,4,4,23
10,1000,-539.992,RV-t,t,7,25,4,6,42
10,1000,-539.992,RV-c,c,1,6,11,2,20
10,1000,-539.992,RV-g,g,1,4,6,8,19
