I,GEN,LogL,RateVector,State,a,t,c,g,Total
0,0,-992.221,RV-a,a,8,2,2,4,16
0,0,-992.221,RV-t,t,5,27,8,4,44
0,0,-992.221,RV-c,c,3,7,11,3,24
0,0,-992.221,RV-g,g,6,8,6,16,36
0,0,-992.221,RV-a,a,0,0,0,0,0
0,0,-992.221,RV-t,t,0,0,0,0,0
0,0,-992.221,RV-c,c,0,0,0,0,0
0,0,-992.221,RV-g,g,0,0,0,0,0
0,0,-992.221,RV-a,a,0,0,0,0,0
0,0,-992.221,RV-t,t,0,0,0,0,0
0,0,-992.221,RV-c,c,0,0,0,0,0
0,0,-992.221,RV-g,g,0,0,0,0,0
0,0,-992.221,RV-A,A,89,0,0,89
0,0,-992.221,RV-B,B,0,0,0,0
0,0,-992.221,RV-C,C,0,0,0,0
1,100,-946.943,RV-a,a,2,1,0,1,4
1,100,-946.943,RV-t,t,4,16,6,3,29
1,100,-946.943,RV-c,c,2,6,9,2,19
1,100,-946.943,RV-g,g,0,3,2,3,8
1,100,-946.943,RV-a,a,9,1,2,2,14
1,100,-946.943,RV-t,t,1,0,0,0,1
1,100,-946.943,RV-c,c,1,0,2,0,3
1,100,-946.943,RV-g,g,3,2,1,3,9
1,100,-946.943,RV-a,a,1,0,0,1,2
1,100,-946.943,RV-t,t,0,3,2,1,6
1,100,-946.943,RV-c,c,0,1,3,1,5
1,100,-946.943,RV-g,g,3,3,3,6,15
1,100,-946.943,RV-A,A,42,0,0,42
1,100,-946.943,RV-B,B,0,17,0,17
1,100,-946.943,RV-C,C,0,0,20,20
2,200,-844.554,RV-a,a,3,1,0,2,6
2,200,-844.554,RV-t,t,4,17,6,3,30
2,200,-844.554,RV-c,c,1,4,10,2,17
2,200,-844.554,RV-g,g,0,1,1,2,4
2,200,-844.554,RV-a,a,7,0,2,1,10
2,200,-844.554,RV-t,t,2,1,0,2,5
2,200,-844.554,RV-c,c,0,0,1,0,1
2,200,-844.554,RV-g,g,2,1,1,2,6
2,200,-844.554,RV-a,a,2,0,1,1,4
2,200,-844.554,RV-t,t,1,5,0,3,9
2,200,-844.554,RV-c,c,0,2,3,0,5
2,200,-844.554,RV-g,g,0,0,2,3,5
2,200,-844.554,RV-A,A,43,0,0,43
2,200,-844.554,RV-B,B,0,12,0,12
2,200,-844.554,RV-C,C,0,0,27,27
3,300,-819.017,RV-a,a,5,1,1,2,9
3,300,-819.017,RV-t,t,1,10,3,4,18
3,300,-819.017,RV-c,c,0,3,8,1,12
3,300,-819.017,RV-g,g,1,2,4,7,14
3,300,-819.017,RV-a,a,0,0,1,1,2
3,300,-819.017,RV-t,t,4,9,1,3,17
3,300,-819.017,RV-c,c,1,1,0,0,2
3,300,-819.017,RV-g,g,1,0,0,1,2
3,300,-819.017,RV-a,a,5,0,1,1,7
3,300,-819.017,RV-t,t,2,4,2,1,9
3,300,-819.017,RV-c,c,0,2,4,1,7
3,300,-819.017,RV-g,g,0,0,0,0,0
3,300,-819.017,RV-A,A,42,0,0,42
3,300,-819.017,RV-B,B,0,18,0,18
3,300,-819.017,RV-C,C,0,0,17,17
4,400,-943.987,RV-a,a,9,0,3,2,14
4,400,-943.987,RV-t,t,2,15,2,3,22
4,400,-943.987,RV-c,c,0,4,6,1,11
4,400,-943.987,RV-g,g,1,3,2,9,15
4,400,-943.987,RV-a,a,3,0,1,0,4
4,400,-943.987,RV-t,t,5,12,1,4,22
4,400,-943.987,RV-c,c,1,1,4,0,6
4,400,-943.987,RV-g,g,0,0,0,0,0
4,400,-943.987,RV-a,a,7,0,1,1,9
4,400,-943.987,RV-t,t,2,6,2,0,10
4,400,-943.987,RV-c,c,0,1,3,1,5
4,400,-943.987,RV-g,g,0,1,1,2,4
4,400,-943.987,RV-A,A,50,0,0,50
4,400,-943.987,RV-B,B,0,26,0,26
4,400,-943.987,RV-C,C,0,0,24,24
5,500,-940.603,RV-a,a,9,0,3,2,14
5,500,-940.603,RV-t,t,2,15,2,3,22
5,500,-940.603,RV-c,c,0,4,6,1,11
5,500,-940.603,RV-g,g,1,3,2,9,15
5,500,-940.603,RV-a,a,3,0,1,0,4
5,500,-940.603,RV-t,t,5,12,1,4,22
5,500,-940.603,RV-c,c,1,1,4,0,6
5,500,-940.603,RV-g,g,0,0,0,0,0
5,500,-940.603,RV-a,a,7,0,1,1,9
5,500,-940.603,RV-t,t,2,6,2,0,10
5,500,-940.603,RV-c,c,0,1,3,1,5
5,500,-940.603,RV-g,g,0,1,1,2,4
5,500,-940.603,RV-A,A,50,0,0,50
5,500,-940.603,RV-B,B,0,26,0,26
5,500,-940.603,RV-C,C,0,0,24,24
6,600,-875.827,RV-a,a,3,0,1,1,5
6,600,-875.827,RV-t,t,3,21,6,5,35
6,600,-875.827,RV-c,c,0,1,0,1,2
6,600,-875.827,RV-g,g,0,1,0,2,3
6,600,-875.827,RV-a,a,2,0,1,0,3
6,600,-875.827,RV-t,t,4,5,0,2,11
6,600,-875.827,RV-c,c,1,4,8,1,14
6,600,-875.827,RV-g,g,0,0,0,0,0
6,600,-875.827,RV-a,a,6,1,2,3,12
6,600,-875.827,RV-t,t,2,10,1,2,15
6,600,-875.827,RV-c,c,0,0,3,1,4
6,600,-875.827,RV-g,g,0,0,2,6,8
6,600,-875.827,RV-A,A,37,0,0,37
6,600,-875.827,RV-B,B,0,27,0,27
6,600,-875.827,RV-C,C,0,0,22,22
7,700,-871.407,RV-a,a,3,0,1,1,5
7,700,-871.407,RV-t,t,3,21,6,5,35
7,700,-871.407,RV-c,c,0,1,0,1,2
7,700,-871.407,RV-g,g,0,1,0,2,3
7,700,-871.407,RV-a,a,2,0,1,0,3
7,700,-871.407,RV-t,t,4,5,0,2,11
7,700,-871.407,RV-c,c,1,4,8,1,14
7,700,-871.407,RV-g,g,0,0,0,0,0
7,700,-871.407,RV-a,a,6,1,2,3,12
7,700,-871.407,RV-t,t,2,10,1,2,15
7,700,-871.407,RV-c,c,0,0,3,1,4
7,700,-871.407,RV-g,g,0,0,2,6,8
7,700,-871.407,RV-A,A,37,0,0,37
7,700,-871.407,RV-B,B,0,27,0,27
7,700,-871.407,RV-C,C,0,0,22,22
8,800,-901.027,RV-a,a,15,1,3,3,22
8,800,-901.027,RV-t,t,5,13,4,6,28
8,800,-901.027,RV-c,c,0,1,4,1,6
8,800,-901.027,RV-g,g,0,0,1,0,1
8,800,-901.027,RV-a,a,0,0,0,0,0
8,800,-901.027,RV-t,t,0,3,1,0,4
8,800,-901.027,RV-c,c,0,3,5,2,10
8,800,-901.027,RV-g,g,0,0,1,3,4
8,800,-901.027,RV-a,a,3,0,1,1,5
8,800,-901.027,RV-t,t,4,14,2,3,23
8,800,-901.027,RV-c,c,1,1,3,0,5
8,800,-901.027,RV-g,g,0,1,0,1,2
8,800,-901.027,RV-A,A,56,0,0,56
8,800,-901.027,RV-B,B,0,15,0,15
8,800,-901.027,RV-C,C,0,0,28,28
9,900,-904.783,RV-a,a,14,0,3,2,19
9,900,-904.783,RV-t,t,6,17,3,6,32
9,900,-904.783,RV-c,c,0,2,7,2,11
9,900,-904.783,RV-g,g,0,0,1,1,2
9,900,-904.783,RV-a,a,0,0,0,0,0
9,900,-904.783,RV-t,t,0,0,0,0,0
9,900,-904.783,RV-c,c,0,4,12,3,19
9,900,-904.783,RV-g,g,0,0,0,0,0
9,900,-904.783,RV-a,a,7,2,1,1,11
9,900,-904.783,RV-t,t,2,11,1,2,16
9,900,-904.783,RV-c,c,1,1,2,0,4
9,900,-904.783,RV-g,g,0,2,1,6,9
9,900,-904.783,RV-A,A,55,0,0,55
9,900,-904.783,RV-B,B,0,13,0,13
9,900,-904.783,RV-C,C,0,0,21,21
10,1000,-869.467,RV-a,a,10,2,3,2,17
10,1000,-869.467,RV-t,t,4,6,0,3,13
10,1000,-869.467,RV-c,c,1,1,3,1,6
10,1000,-869.467,RV-g,g,0,2,2,3,7
10,1000,-869.467,RV-a,a,0,0,0,0,0
10,1000,-869.467,RV-t,t,1,7,2,2,12
10,1000,-869.467,RV-c,c,0,4,8,0,12
10,1000,-869.467,RV-g,g,0,0,0,0,0
10,1000,-869.467,RV-a,a,6,0,1,1,8
10,1000,-869.467,RV-t,t,3,13,2,3,21
10,1000,-869.467,RV-c,c,0,2,6,4,12
10,1000,-869.467,RV-g,g,0,0,0,1,1
10,1000,-869.467,RV-A,A,33,0,0,33
10,1000,-869.467,RV-B,B,0,18,0,18
10,1000,-869.467,RV-C,C,0,0,37,37
