I,GEN,LogL,RateVector,State,a,t,c,g,Total
0,0,-656.617,RV-a,a,24,5,7,3,39
0,0,-656.617,RV-t,t,6,39,8,7,60
0,0,-656.617,RV-c,c,0,3,8,2,13
0,0,-656.617,RV-g,g,3,2,0,6,11
1,100,-573.78,RV-a,a,24,5,7,3,39
1,100,-573.78,RV-t,t,6,39,8,7,60
1,100,-573.78,RV-c,c,0,3,8,2,13
1,100,-573.78,RV-g,g,3,2,0,6,11
2,200,-514.182,RV-a,a,20,4,6,4,34
2,200,-514.182,RV-t,t,7,30,7,5,49
2,200,-514.182,RV-c,c,1,6,9,3,19
2,200,-514.182,RV-g,g,1,2,0,5,8
3,300,-502.726,RV-a,a,20,4,6,4,34
3,300,-502.726,RV-t,t,7,30,7,5,49
3,300,-502.726,RV-c,c,1,6,9,3,19
3,300,-502.726,RV-g,g,1,2,0,5,8
4,400,-471.439,RV-a,a,20,6,4,3,33
4,400,-471.439,RV-t,t,4,29,8,7,48
4,400,-471.439,RV-c,c,2,4,4,2,12
4,400,-471.439,RV-g,g,2,2,2,2,8
5,500,-472.959,RV-a,a,20,6,4,3,33
5,500,-472.959,RV-t,t,4,29,8,7,48
5,500,-472.959,RV-c,c,2,4,4,2,12
5,500,-472.959,RV-g,g,2,2,2,2,8
6,600,-504.528,RV-a,a,17,6,7,4,34
6,600,-504.528,RV-t,t,6,31,7,7,51
6,600,-504.528,RV-c,c,2,5,10,2,19
6,600,-504.528,RV-g,g,2,1,1,3,7
7,700,-501.225,RV-a,a,17,6,7,4,34
7,700,-501.225,RV-t,t,6,31,7,7,51
7,700,-501.225,RV-c,c,2,5,10,2,19
7,700,-501.225,RV-g,g,2,1,1,3,7
8,800,-441.237,RV-a,a,16,5,5,4,30
8,800,-441.237,RV-t,t,7,24,6,7,44
8,800,-441.237,RV-c,c,1,5,6,2,14
8,800,-441.237,RV-g,g,1,1,2,4,8
9,900,-438.931,RV-a,a,16,5,5,4,30
9,900,-438.931,RV-t,t,7,24,6,7,44
9,900,-438.931,RV-c,c,1,5,6,2,14
9,900,-438.931,RV-g,g,1,1,2,4,8
10,1000,-465.292,RV-a,a,15,3,6,2,26
10,1000,-465.292,RV-t,t,9,32,8,9,58
10,1000,-465.292,RV-c,c,0,4,9,2,15
10,1000,-465.292,RV-g,g,2,1,0,3,6
