I,GEN,LogL,RateVector,State,a,t,c,g,Total
0,0,-1589.65,RV-order-a,a,10,4,1,3,18
0,0,-1589.65,RV-disorder-a,a,8,1,1,1,11
0,0,-1589.65,RV-order-t,t,2,23,6,3,34
0,0,-1589.65,RV-disorder-t,t,0,12,1,2,15
0,0,-1589.65,RV-order-c,c,5,4,19,3,31
0,0,-1589.65,RV-disorder-c,c,0,2,12,4,18
0,0,-1589.65,RV-order-g,g,0,5,2,8,15
0,0,-1589.65,RV-disorder-g,g,1,2,0,6,9
0,0,-1589.65,RV-O,O,76,19,95
0,0,-1589.65,RV-D,D,17,42,59
1,100,-1480.57,RV-order-a,a,10,4,1,3,18
1,100,-1480.57,RV-disorder-a,a,8,1,1,1,11
1,100,-1480.57,RV-order-t,t,2,23,6,3,34
1,100,-1480.57,RV-disorder-t,t,0,12,1,2,15
1,100,-1480.57,RV-order-c,c,5,4,19,3,31
1,100,-1480.57,RV-disorder-c,c,0,2,12,4,18
1,100,-1480.57,RV-order-g,g,0,5,2,8,15
1,100,-1480.57,RV-disorder-g,g,1,2,0,6,9
1,100,-1480.57,RV-O,O,76,19,95
1,100,-1480.57,RV-D,D,17,42,59
2,200,-1448.05,RV-order-a,a,10,4,1,3,18
2,200,-1448.05,RV-disorder-a,a,8,1,1,1,11
2,200,-1448.05,RV-order-t,t,2,23,6,3,34
2,200,-1448.05,RV-disorder-t,t,0,12,1,2,15
2,200,-1448.05,RV-order-c,c,5,4,19,3,31
2,200,-1448.05,RV-disorder-c,c,0,2,12,4,18
2,200,-1448.05,RV-order-g,g,0,5,2,8,15
2,200,-1448.05,RV-disorder-g,g,1,2,0,6,9
2,200,-1448.05,RV-O,O,76,19,95
2,200,-1448.05,RV-D,D,17,42,59
3,300,-1503.57,RV-order-a,a,12,4,4,2,22
3,300,-1503.57,RV-disorder-a,a,12,0,2,3,17
3,300,-1503.57,RV-order-t,t,7,32,4,7,50
3,300,-1503.57,RV-disorder-t,t,1,15,3,2,21
3,300,-1503.57,RV-order-c,c,1,8,12,2,23
3,300,-1503.57,RV-disorder-c,c,0,2,13,1,16
3,300,-1503.57,RV-order-g,g,4,0,2,4,10
3,300,-1503.57,RV-disorder-g,g,1,2,1,5,9
3,300,-1503.57,RV-O,O,76,20,96
3,300,-1503.57,RV-D,D,11,49,60
4,400,-1487.41,RV-order-a,a,12,4,4,2,22
4,400,-1487.41,RV-disorder-a,a,12,0,2,3,17
4,400,-1487.41,RV-order-t,t,7,32,4,7,50
4,400,-1487.41,RV-disorder-t,t,1,15,3,2,21
4,400,-1487.41,RV-order-c,c,1,8,12,2,23
4,400,-1487.41,RV-disorder-c,c,0,2,13,1,16
4,400,-1487.41,RV-order-g,g,4,0,2,4,10
4,400,-1487.41,RV-disorder-g,g,1,2,1,5,9
4,400,-1487.41,RV-O,O,76,20,96
4,400,-1487.41,RV-D,D,11,49,60
5,500,-1473.42,RV-order-a,a,12,4,4,2,22
5,500,-1473.42,RV-disorder-a,a,12,0,2,3,17
5,500,-1473.42,RV-order-t,t,7,32,4,7,50
5,500,-1473.42,RV-disorder-t,t,1,15,3,2,21
5,500,-1473.42,RV-order-c,c,1,8,12,2,23
5,500,-1473.42,RV-disorder-c,c,0,2,13,1,16
5,500,-1473.42,RV-order-g,g,4,0,2,4,10
5,500,-1473.42,RV-disorder-g,g,1,2,1,5,9
5,500,-1473.42,RV-O,O,76,20,96
5,500,-1473.42,RV-D,D,11,49,60
6,600,-1510.95,RV-order-a,a,20,5,1,4,30
6,600,-1510.95,RV-disorder-a,a,12,1,5,3,21
6,600,-1510.95,RV-order-t,t,5,28,5,2,40
6,600,-1510.95,RV-disorder-t,t,1,12,2,3,18
6,600,-1510.95,RV-order-c,c,1,5,10,1,17
6,600,-1510.95,RV-disorder-c,c,0,2,9,3,14
6,600,-1510.95,RV-order-g,g,1,0,4,7,12
6,600,-1510.95,RV-disorder-g,g,1,3,2,8,14
6,600,-1510.95,RV-O,O,77,23,100
6,600,-1510.95,RV-D,D,17,46,63
7,700,-1503.97,RV-order-a,a,20,5,1,4,30
7,700,-1503.97,RV-disorder-a,a,12,1,5,3,21
7,700,-1503.97,RV-order-t,t,5,28,5,2,40
7,700,-1503.97,RV-disorder-t,t,1,12,2,3,18
7,700,-1503.97,RV-order-c,c,1,5,10,1,17
7,700,-1503.97,RV-disorder-c,c,0,2,9,3,14
7,700,-1503.97,RV-order-g,g,1,0,4,7,12
7,700,-1503.97,RV-disorder-g,g,1,3,2,8,14
7,700,-1503.97,RV-O,O,77,23,100
7,700,-1503.97,RV-D,D,17,46,63
8,800,-1472.67,RV-order-a,a,14,5,4,2,25
8,800,-1472.67,RV-disorder-a,a,11,0,3,2,16
8,800,-1472.67,RV-order-t,t,3,23,3,3,32
8,800,-1472.67,RV-disorder-t,t,3,15,3,5,26
8,800,-1472.67,RV-order-c,c,1,5,16,1,23
8,800,-1472.67,RV-disorder-c,c,0,1,8,1,10
8,800,-1472.67,RV-order-g,g,3,4,2,7,16
8,800,-1472.67,RV-disorder-g,g,1,2,1,10,14
8,800,-1472.67,RV-O,O,73,23,96
8,800,-1472.67,RV-D,D,17,46,63
9,900,-1469.59,RV-order-a,a,14,5,4,2,25
9,900,-1469.59,RV-disorder-a,a,11,0,3,2,16
9,900,-1469.59,RV-order-t,t,3,23,3,3,32
9,900,-1469.59,RV-disorder-t,t,3,15,3,5,26
9,900,-1469.59,RV-order-c,c,1,5,16,1,23
9,900,-1469.59,RV-disorder-c,c,0,1,8,1,10
9,900,-1469.59,RV-order-g,g,3,4,2,7,16
9,900,-1469.59,RV-disorder-g,g,1,2,1,10,14
9,900,-1469.59,RV-O,O,73,23,96
9,900,-1469.59,RV-D,D,17,46,63
10,1000,-1465.87,RV-order-a,a,14,5,4,2,25
10,1000,-1465.87,RV-disorder-a,a,11,0,3,2,16
10,1000,-1465.87,RV-order-t,t,3,23,3,3,32
10,1000,-1465.87,RV-disorder-t,t,3,15,3,5,26
10,1000,-1465.87,RV-order-c,c,1,5,16,1,23
10,1000,-1465.87,RV-disorder-c,c,0,1,8,1,10
10,1000,-1465.87,RV-order-g,g,3,4,2,7,16
10,1000,-1465.87,RV-disorder-g,g,1,2,1,10,14
10,1000,-1465.87,RV-O,O,73,23,96
10,1000,-1465.87,RV-D,D,17,46,63
