I,GEN,LogL,RateVector,State,a,t,c,g,Total
0,0,-1576.15,RV-order-a,a,11,2,2,2,17
0,0,-1576.15,RV-disorder-a,a,3,1,2,2,8
0,0,-1576.15,RV-order-t,t,3,23,4,5,35
0,0,-1576.15,RV-disorder-t,t,1,11,2,3,17
0,0,-1576.15,RV-order-c,c,1,6,14,3,24
0,0,-1576.15,RV-disorder-c,c,0,1,9,0,10
0,0,-1576.15,RV-order-g,g,2,2,2,11,17
0,0,-1576.15,RV-disorder-g,g,2,1,1,5,9
0,0,-1576.15,RV-O,O,84,21,105
0,0,-1576.15,RV-D,D,20,35,55
1,100,-1456.98,RV-order-a,a,11,2,2,2,17
1,100,-1456.98,RV-disorder-a,a,3,1,2,2,8
1,100,-1456.98,RV-order-t,t,3,23,4,5,35
1,100,-1456.98,RV-disorder-t,t,1,11,2,3,17
1,100,-1456.98,RV-order-c,c,1,6,14,3,24
1,100,-1456.98,RV-disorder-c,c,0,1,9,0,10
1,100,-1456.98,RV-order-g,g,2,2,2,11,17
1,100,-1456.98,RV-disorder-g,g,2,1,1,5,9
1,100,-1456.98,RV-O,O,84,21,105
1,100,-1456.98,RV-D,D,20,35,55
2,200,-1410.94,RV-order-a,a,11,2,2,2,17
2,200,-1410.94,RV-disorder-a,a,3,1,2,2,8
2,200,-1410.94,RV-order-t,t,3,23,4,5,35
2,200,-1410.94,RV-disorder-t,t,1,11,2,3,17
2,200,-1410.94,RV-order-c,c,1,6,14,3,24
2,200,-1410.94,RV-disorder-c,c,0,1,9,0,10
2,200,-1410.94,RV-order-g,g,2,2,2,11,17
2,200,-1410.94,RV-disorder-g,g,2,1,1,5,9
2,200,-1410.94,RV-O,O,84,21,105
2,200,-1410.94,RV-D,D,20,35,55
3,300,-1373.39,RV-order-a,a,16,4,1,3,24
3,300,-1373.39,RV-disorder-a,a,13,1,2,3,19
3,300,-1373.39,RV-order-t,t,3,28,4,2,37
3,300,-1373.39,RV-disorder-t,t,0,16,2,5,23
3,300,-1373.39,RV-order-c,c,1,5,15,1,22
3,300,-1373.39,RV-disorder-c,c,0,0,9,0,9
3,300,-1373.39,RV-order-g,g,1,0,1,7,9
3,300,-1373.39,RV-disorder-g,g,2,4,4,10,20
3,300,-1373.39,RV-O,O,69,19,88
3,300,-1373.39,RV-D,D,17,32,49
4,400,-1355.41,RV-order-a,a,16,4,1,3,24
4,400,-1355.41,RV-disorder-a,a,13,1,2,3,19
4,400,-1355.41,RV-order-t,t,3,28,4,2,37
4,400,-1355.41,RV-disorder-t,t,0,16,2,5,23
4,400,-1355.41,RV-order-c,c,1,5,15,1,22
4,400,-1355.41,RV-disorder-c,c,0,0,9,0,9
4,400,-1355.41,RV-order-g,g,1,0,1,7,9
4,400,-1355.41,RV-disorder-g,g,2,4,4,10,20
4,400,-1355.41,RV-O,O,69,19,88
4,400,-1355.41,RV-D,D,17,32,49
5,500,-1315.55,RV-order-a,a,16,1,1,2,20
5,500,-1315.55,RV-disorder-a,a,8,0,3,2,13
5,500,-1315.55,RV-order-t,t,5,31,2,6,44
5,500,-1315.55,RV-disorder-t,t,0,9,2,3,14
5,500,-1315.55,RV-order-c,c,1,6,12,1,20
5,500,-1315.55,RV-disorder-c,c,0,1,12,2,15
5,500,-1315.55,RV-order-g,g,2,1,1,6,10
5,500,-1315.55,RV-disorder-g,g,2,2,2,8,14
5,500,-1315.55,RV-O,O,62,19,81
5,500,-1315.55,RV-D,D,12,54,66
6,600,-1305.74,RV-order-a,a,16,1,1,2,20
6,600,-1305.74,RV-disorder-a,a,8,0,3,2,13
6,600,-1305.74,RV-order-t,t,5,31,2,6,44
6,600,-1305.74,RV-disorder-t,t,0,9,2,3,14
6,600,-1305.74,RV-order-c,c,1,6,12,1,20
6,600,-1305.74,RV-disorder-c,c,0,1,12,2,15
6,600,-1305.74,RV-order-g,g,2,1,1,6,10
6,600,-1305.74,RV-disorder-g,g,2,2,2,8,14
6,600,-1305.74,RV-O,O,62,19,81
6,600,-1305.74,RV-D,D,12,54,66
7,700,-1359.25,RV-order-a,a,19,3,1,2,25
7,700,-1359.25,RV-disorder-a,a,8,0,2,2,12
7,700,-1359.25,RV-order-t,t,4,18,3,4,29
7,700,-1359.25,RV-disorder-t,t,0,12,0,3,15
7,700,-1359.25,RV-order-c,c,1,5,15,2,23
7,700,-1359.25,RV-disorder-c,c,0,2,10,1,13
7,700,-1359.25,RV-order-g,g,1,2,1,5,9
7,700,-1359.25,RV-disorder-g,g,2,2,4,12,20
7,700,-1359.25,RV-O,O,71,19,90
7,700,-1359.25,RV-D,D,12,68,80
8,800,-1291.26,RV-order-a,a,14,2,1,1,18
8,800,-1291.26,RV-disorder-a,a,10,1,2,3,16
8,800,-1291.26,RV-order-t,t,4,27,3,5,39
8,800,-1291.26,RV-disorder-t,t,0,16,0,2,18
8,800,-1291.26,RV-order-c,c,1,5,18,2,26
8,800,-1291.26,RV-disorder-c,c,0,2,7,1,10
8,800,-1291.26,RV-order-g,g,1,1,0,3,5
8,800,-1291.26,RV-disorder-g,g,2,3,5,7,17
8,800,-1291.26,RV-O,O,69,17,86
8,800,-1291.26,RV-D,D,12,50,62
9,900,-1293.29,RV-order-a,a,13,4,1,1,19
9,900,-1293.29,RV-disorder-a,a,7,0,3,3,13
9,900,-1293.29,RV-order-t,t,3,29,4,3,39
9,900,-1293.29,RV-disorder-t,t,1,15,0,3,19
9,900,-1293.29,RV-order-c,c,1,4,17,1,23
9,900,-1293.29,RV-disorder-c,c,0,2,17,3,22
9,900,-1293.29,RV-order-g,g,2,2,1,5,10
9,900,-1293.29,RV-disorder-g,g,1,2,2,9,14
9,900,-1293.29,RV-O,O,70,17,87
9,900,-1293.29,RV-D,D,12,40,52
10,1000,-1311.15,RV-order-a,a,15,3,1,2,21
10,1000,-1311.15,RV-disorder-a,a,11,1,3,2,17
10,1000,-1311.15,RV-order-t,t,3,26,4,5,38
10,1000,-1311.15,RV-disorder-t,t,1,11,0,1,13
10,1000,-1311.15,RV-order-c,c,1,4,15,1,21
10,1000,-1311.15,RV-disorder-c,c,0,2,11,3,16
10,1000,-1311.15,RV-order-g,g,2,1,1,5,9
10,1000,-1311.15,RV-disorder-g,g,1,3,2,6,12
10,1000,-1311.15,RV-O,O,69,20,89
10,1000,-1311.15,RV-D,D,13,52,65
