I,GEN,LogL,RateVector,State,a,t,c,g,Total
0,0,-1693.61,RV-order-a,a,14,1,2,2,19
0,0,-1693.61,RV-disorder-a,a,7,1,1,1,10
0,0,-1693.61,RV-order-t,t,4,24,7,5,40
0,0,-1693.61,RV-disorder-t,t,1,16,4,1,22
0,0,-1693.61,RV-order-c,c,3,2,15,3,23
0,0,-1693.61,RV-disorder-c,c,3,3,14,3,23
0,0,-1693.61,RV-order-g,g,2,5,0,6,13
0,0,-1693.61,RV-disorder-g,g,1,4,2,4,11
0,0,-1693.61,RV-O,O,69,15,84
0,0,-1693.61,RV-D,D,27,38,65
1,100,-1557.88,RV-order-a,a,14,1,2,2,19
1,100,-1557.88,RV-disorder-a,a,7,1,1,1,10
1,100,-1557.88,RV-order-t,t,4,24,7,5,40
1,100,-1557.88,RV-disorder-t,t,1,16,4,1,22
1,100,-1557.88,RV-order-c,c,3,2,15,3,23
1,100,-1557.88,RV-disorder-c,c,3,3,14,3,23
1,100,-1557.88,RV-order-g,g,2,5,0,6,13
1,100,-1557.88,RV-disorder-g,g,1,4,2,4,11
1,100,-1557.88,RV-O,O,69,15,84
1,100,-1557.88,RV-D,D,27,38,65
2,200,-1508.43,RV-order-a,a,14,1,2,2,19
2,200,-1508.43,RV-disorder-a,a,7,1,1,1,10
2,200,-1508.43,RV-order-t,t,4,24,7,5,40
2,200,-1508.43,RV-disorder-t,t,1,16,4,1,22
2,200,-1508.43,RV-order-c,c,3,2,15,3,23
2,200,-1508.43,RV-disorder-c,c,3,3,14,3,23
2,200,-1508.43,RV-order-g,g,2,5,0,6,13
2,200,-1508.43,RV-disorder-g,g,1,4,2,4,11
2,200,-1508.43,RV-O,O,69,15,84
2,200,-1508.43,RV-D,D,27,38,65
3,300,-1412.61,RV-order-a,a,13,3,4,1,21
3,300,-1412.61,RV-disorder-a,a,15,1,3,2,21
3,300,-1412.61,RV-order-t,t,5,19,6,4,34
3,300,-1412.61,RV-disorder-t,t,1,17,0,2,20
3,300,-1412.61,RV-order-c,c,0,6,11,3,20
3,300,-1412.61,RV-disorder-c,c,0,2,6,1,9
3,300,-1412.61,RV-order-g,g,2,4,1,4,11
3,300,-1412.61,RV-disorder-g,g,1,2,2,8,13
3,300,-1412.61,RV-O,O,70,23,93
3,300,-1412.61,RV-D,D,15,42,57
4,400,-1394.51,RV-order-a,a,13,3,4,1,21
4,400,-1394.51,RV-disorder-a,a,15,1,3,2,21
4,400,-1394.51,RV-order-t,t,5,19,6,4,34
4,400,-1394.51,RV-disorder-t,t,1,17,0,2,20
4,400,-1394.51,RV-order-c,c,0,6,11,3,20
4,400,-1394.51,RV-disorder-c,c,0,2,6,1,9
4,400,-1394.51,RV-order-g,g,2,4,1,4,11
4,400,-1394.51,RV-disorder-g,g,1,2,2,8,13
4,400,-1394.51,RV-O,O,70,23,93
4,400,-1394.51,RV-D,D,15,42,57
5,500,-1385.74,RV-order-a,a,13,3,4,1,21
5,500,-1385.74,RV-disorder-a,a,15,1,3,2,21
5,500,-1385.74,RV-order-t,t,5,19,6,4,34
5,500,-1385.74,RV-disorder-t,t,1,17,0,2,20
5,500,-1385.74,RV-order-c,c,0,6,11,3,20
5,500,-1385.74,RV-disorder-c,c,0,2,6,1,9
5,500,-1385.74,RV-order-g,g,2,4,1,4,11
5,500,-1385.74,RV-disorder-g,g,1,2,2,8,13
5,500,-1385.74,RV-O,O,70,23,93
5,500,-1385.74,RV-D,D,15,42,57
6,600,-1474.47,RV-order-a,a,18,2,2,5,27
6,600,-1474.47,RV-disorder-a,a,14,1,3,2,20
6,600,-1474.47,RV-order-t,t,5,35,7,5,52
6,600,-1474.47,RV-disorder-t,t,2,16,0,2,20
6,600,-1474.47,RV-order-c,c,1,6,10,3,20
6,600,-1474.47,RV-disorder-c,c,0,2,10,0,12
6,600,-1474.47,RV-order-g,g,0,4,1,3,8
6,600,-1474.47,RV-disorder-g,g,2,2,1,6,11
6,600,-1474.47,RV-O,O,74,28,102
6,600,-1474.47,RV-D,D,11,41,52
7,700,-1469.62,RV-order-a,a,18,2,2,5,27
7,700,-1469.62,RV-disorder-a,a,14,1,3,2,20
7,700,-1469.62,RV-order-t,t,5,35,7,5,52
7,700,-1469.62,RV-disorder-t,t,2,16,0,2,20
7,700,-1469.62,RV-order-c,c,1,6,10,3,20
7,700,-1469.62,RV-disorder-c,c,0,2,10,0,12
7,700,-1469.62,RV-order-g,g,0,4,1,3,8
7,700,-1469.62,RV-disorder-g,g,2,2,1,6,11
7,700,-1469.62,RV-O,O,74,28,102
7,700,-1469.62,RV-D,D,11,41,52
8,800,-1348.77,RV-order-a,a,16,2,2,1,21
8,800,-1348.77,RV-disorder-a,a,12,3,4,5,24
8,800,-1348.77,RV-order-t,t,3,23,4,4,34
8,800,-1348.77,RV-disorder-t,t,3,12,4,4,23
8,800,-1348.77,RV-order-c,c,1,6,12,2,21
8,800,-1348.77,RV-disorder-c,c,0,0,6,0,6
8,800,-1348.77,RV-order-g,g,3,2,3,6,14
8,800,-1348.77,RV-disorder-g,g,0,1,1,7,9
8,800,-1348.77,RV-O,O,57,21,78
8,800,-1348.77,RV-D,D,14,49,63
9,900,-1339.82,RV-order-a,a,16,2,2,1,21
9,900,-1339.82,RV-disorder-a,a,12,3,4,5,24
9,900,-1339.82,RV-order-t,t,3,23,4,4,34
9,900,-1339.82,RV-disorder-t,t,3,12,4,4,23
9,900,-1339.82,RV-order-c,c,1,6,12,2,21
9,900,-1339.82,RV-disorder-c,c,0,0,6,0,6
9,900,-1339.82,RV-order-g,g,3,2,3,6,14
9,900,-1339.82,RV-disorder-g,g,0,1,1,7,9
9,900,-1339.82,RV-O,O,57,21,78
9,900,-1339.82,RV-D,D,14,49,63
10,1000,-1333.17,RV-order-a,a,16,2,2,1,21
10,1000,-1333.17,RV-disorder-a,a,12,3,4,5,24
10,1000,-1333.17,RV-order-t,t,3,23,4,4,34
10,1000,-1333.17,RV-disorder-t,t,3,12,4,4,23
10,1000,-1333.17,RV-order-c,c,1,6,12,2,21
10,1000,-1333.17,RV-disorder-c,c,0,0,6,0,6
10,1000,-1333.17,RV-order-g,g,3,2,3,6,14
10,1000,-1333.17,RV-disorder-g,g,0,1,1,7,9
10,1000,-1333.17,RV-O,O,57,21,78
10,1000,-1333.17,RV-D,D,14,49,63
