I,GEN,LogL,RateVector,State,a,t,c,g,Total
0,0,-1746.57,RV-order-a,a,16,2,1,2,21
0,0,-1746.57,RV-disorder-a,a,7,1,1,2,11
0,0,-1746.57,RV-order-t,t,4,32,8,6,50
0,0,-1746.57,RV-disorder-t,t,1,15,3,2,21
0,0,-1746.57,RV-order-c,c,2,3,12,1,18
0,0,-1746.57,RV-disorder-c,c,2,1,10,0,13
0,0,-1746.57,RV-order-g,g,2,4,5,12,23
0,0,-1746.57,RV-disorder-g,g,1,3,2,6,12
0,0,-1746.57,RV-O,O,85,21,106
0,0,-1746.57,RV-D,D,21,33,54
1,50,-1609.51,RV-order-a,a,7,1,1,1,10
1,50,-1609.51,RV-disorder-a,a,11,2,1,3,17
1,50,-1609.51,RV-order-t,t,2,20,5,4,31
1,50,-1609.51,RV-disorder-t,t,3,28,6,4,41
1,50,-1609.51,RV-order-c,c,1,1,6,1,9
1,50,-1609.51,RV-disorder-c,c,3,3,22,0,28
1,50,-1609.51,RV-order-g,g,1,5,1,5,12
1,50,-1609.51,RV-disorder-g,g,2,2,6,12,22
1,50,-1609.51,RV-O,O,47,9,56
1,50,-1609.51,RV-D,D,24,76,100
2,100,-1568.16,RV-order-a,a,7,1,1,1,10
2,100,-1568.16,RV-disorder-a,a,11,2,1,3,17
2,100,-1568.16,RV-order-t,t,2,20,5,4,31
2,100,-1568.16,RV-disorder-t,t,3,28,6,4,41
2,100,-1568.16,RV-order-c,c,1,1,6,1,9
2,100,-1568.16,RV-disorder-c,c,3,3,22,0,28
2,100,-1568.16,RV-order-g,g,1,5,1,5,12
2,100,-1568.16,RV-disorder-g,g,2,2,6,12,22
2,100,-1568.16,RV-O,O,47,9,56
2,100,-1568.16,RV-D,D,24,76,100
3,150,-1539.66,RV-order-a,a,7,1,1,1,10
3,150,-1539.66,RV-disorder-a,a,11,2,1,3,17
3,150,-1539.66,RV-order-t,t,2,20,5,4,31
3,150,-1539.66,RV-disorder-t,t,3,28,6,4,41
3,150,-1539.66,RV-order-c,c,1,1,6,1,9
3,150,-1539.66,RV-disorder-c,c,3,3,22,0,28
3,150,-1539.66,RV-order-g,g,1,5,1,5,12
3,150,-1539.66,RV-disorder-g,g,2,2,6,12,22
3,150,-1539.66,RV-O,O,47,9,56
3,150,-1539.66,RV-D,D,24,76,100
4,200,-1521.13,RV-order-a,a,7,1,1,1,10
4,200,-1521.13,RV-disorder-a,a,11,2,1,3,17
4,200,-1521.13,RV-order-t,t,2,20,5,4,31
4,200,-1521.13,RV-disorder-t,t,3,28,6,4,41
4,200,-1521.13,RV-order-c,c,1,1,6,1,9
4,200,-1521.13,RV-disorder-c,c,3,3,22,0,28
4,200,-1521.13,RV-order-g,g,1,5,1,5,12
4,200,-1521.13,RV-disorder-g,g,2,2,6,12,22
4,200,-1521.13,RV-O,O,47,9,56
4,200,-1521.13,RV-D,D,24,76,100
5,250,-1485.6,RV-order-a,a,19,4,1,3,27
5,250,-1485.6,RV-disorder-a,a,18,2,6,3,29
5,250,-1485.6,RV-order-t,t,2,8,0,1,11
5,250,-1485.6,RV-disorder-t,t,3,21,1,3,28
5,250,-1485.6,RV-order-c,c,0,4,20,3,27
5,250,-1485.6,RV-disorder-c,c,0,6,21,4,31
5,250,-1485.6,RV-order-g,g,0,1,1,2,4
5,250,-1485.6,RV-disorder-g,g,3,3,2,9,17
5,250,-1485.6,RV-O,O,50,9,59
5,250,-1485.6,RV-D,D,24,66,90
6,300,-1474.26,RV-order-a,a,19,4,1,3,27
6,300,-1474.26,RV-disorder-a,a,18,2,6,3,29
6,300,-1474.26,RV-order-t,t,2,8,0,1,11
6,300,-1474.26,RV-disorder-t,t,3,21,1,3,28
6,300,-1474.26,RV-order-c,c,0,4,20,3,27
6,300,-1474.26,RV-disorder-c,c,0,6,21,4,31
6,300,-1474.26,RV-order-g,g,0,1,1,2,4
6,300,-1474.26,RV-disorder-g,g,3,3,2,9,17
6,300,-1474.26,RV-O,O,50,9,59
6,300,-1474.26,RV-D,D,24,66,90
7,350,-1469.47,RV-order-a,a,19,4,1,3,27
7,350,-1469.47,RV-disorder-a,a,18,2,6,3,29
7,350,-1469.47,RV-order-t,t,2,8,0,1,11
7,350,-1469.47,RV-disorder-t,t,3,21,1,3,28
7,350,-1469.47,RV-order-c,c,0,4,20,3,27
7,350,-1469.47,RV-disorder-c,c,0,6,21,4,31
7,350,-1469.47,RV-order-g,g,0,1,1,2,4
7,350,-1469.47,RV-disorder-g,g,3,3,2,9,17
7,350,-1469.47,RV-O,O,50,9,59
7,350,-1469.47,RV-D,D,24,66,90
8,400,-1464.18,RV-order-a,a,19,4,1,3,27
8,400,-1464.18,RV-disorder-a,a,18,2,6,3,29
8,400,-1464.18,RV-order-t,t,2,8,0,1,11
8,400,-1464.18,RV-disorder-t,t,3,21,1,3,28
8,400,-1464.18,RV-order-c,c,0,4,20,3,27
8,400,-1464.18,RV-disorder-c,c,0,6,21,4,31
8,400,-1464.18,RV-order-g,g,0,1,1,2,4
8,400,-1464.18,RV-disorder-g,g,3,3,2,9,17
8,400,-1464.18,RV-O,O,50,9,59
8,400,-1464.18,RV-D,D,24,66,90
9,450,-1455.33,RV-order-a,a,19,4,1,3,27
9,450,-1455.33,RV-disorder-a,a,18,2,6,3,29
9,450,-1455.33,RV-order-t,t,2,8,0,1,11
9,450,-1455.33,RV-disorder-t,t,3,21,1,3,28
9,450,-1455.33,RV-order-c,c,0,4,20,3,27
9,450,-1455.33,RV-disorder-c,c,0,6,21,4,31
9,450,-1455.33,RV-order-g,g,0,1,1,2,4
9,450,-1455.33,RV-disorder-g,g,3,3,2,9,17
9,450,-1455.33,RV-O,O,50,9,59
9,450,-1455.33,RV-D,D,24,66,90
10,500,-1451.52,RV-order-a,a,19,4,1,3,27
10,500,-1451.52,RV-disorder-a,a,18,2,6,3,29
10,500,-1451.52,RV-order-t,t,2,8,0,1,11
10,500,-1451.52,RV-disorder-t,t,3,21,1,3,28
10,500,-1451.52,RV-order-c,c,0,4,20,3,27
10,500,-1451.52,RV-disorder-c,c,0,6,21,4,31
10,500,-1451.52,RV-order-g,g,0,1,1,2,4
10,500,-1451.52,RV-disorder-g,g,3,3,2,9,17
10,500,-1451.52,RV-O,O,50,9,59
10,500,-1451.52,RV-D,D,24,66,90
11,550,-1424.55,RV-order-a,a,23,4,4,4,35
11,550,-1424.55,RV-disorder-a,a,13,2,3,2,20
11,550,-1424.55,RV-order-t,t,4,27,1,4,36
11,550,-1424.55,RV-disorder-t,t,1,0,0,0,1
11,550,-1424.55,RV-order-c,c,0,6,21,5,32
11,550,-1424.55,RV-disorder-c,c,0,4,11,2,17
11,550,-1424.55,RV-order-g,g,3,3,3,13,22
11,550,-1424.55,RV-disorder-g,g,0,1,0,1,2
11,550,-1424.55,RV-O,O,84,23,107
11,550,-1424.55,RV-D,D,9,33,42
12,600,-1422.56,RV-order-a,a,23,4,4,4,35
12,600,-1422.56,RV-disorder-a,a,13,2,3,2,20
12,600,-1422.56,RV-order-t,t,4,27,1,4,36
12,600,-1422.56,RV-disorder-t,t,1,0,0,0,1
12,600,-1422.56,RV-order-c,c,0,6,21,5,32
12,600,-1422.56,RV-disorder-c,c,0,4,11,2,17
12,600,-1422.56,RV-order-g,g,3,3,3,13,22
12,600,-1422.56,RV-disorder-g,g,0,1,0,1,2
12,600,-1422.56,RV-O,O,84,23,107
12,600,-1422.56,RV-D,D,9,33,42
13,650,-1417.59,RV-order-a,a,23,4,4,4,35
13,650,-1417.59,RV-disorder-a,a,13,2,3,2,20
13,650,-1417.59,RV-order-t,t,4,27,1,4,36
13,650,-1417.59,RV-disorder-t,t,1,0,0,0,1
13,650,-1417.59,RV-order-c,c,0,6,21,5,32
13,650,-1417.59,RV-disorder-c,c,0,4,11,2,17
13,650,-1417.59,RV-order-g,g,3,3,3,13,22
13,650,-1417.59,RV-disorder-g,g,0,1,0,1,2
13,650,-1417.59,RV-O,O,84,23,107
13,650,-1417.59,RV-D,D,9,33,42
14,700,-1409.48,RV-order-a,a,23,4,4,4,35
14,700,-1409.48,RV-disorder-a,a,13,2,3,2,20
14,700,-1409.48,RV-order-t,t,4,27,1,4,36
14,700,-1409.48,RV-disorder-t,t,1,0,0,0,1
14,700,-1409.48,RV-order-c,c,0,6,21,5,32
14,700,-1409.48,RV-disorder-c,c,0,4,11,2,17
14,700,-1409.48,RV-order-g,g,3,3,3,13,22
14,700,-1409.48,RV-disorder-g,g,0,1,0,1,2
14,700,-1409.48,RV-O,O,84,23,107
14,700,-1409.48,RV-D,D,9,33,42
15,750,-1402.23,RV-order-a,a,23,4,4,4,35
15,750,-1402.23,RV-disorder-a,a,13,2,3,2,20
15,750,-1402.23,RV-order-t,t,4,27,1,4,36
15,750,-1402.23,RV-disorder-t,t,1,0,0,0,1
15,750,-1402.23,RV-order-c,c,0,6,21,5,32
15,750,-1402.23,RV-disorder-c,c,0,4,11,2,17
15,750,-1402.23,RV-order-g,g,3,3,3,13,22
15,750,-1402.23,RV-disorder-g,g,0,1,0,1,2
15,750,-1402.23,RV-O,O,84,23,107
15,750,-1402.23,RV-D,D,9,33,42
16,800,-1313.63,RV-order-a,a,6,4,1,1,12
16,800,-1313.63,RV-disorder-a,a,2,0,0,0,2
16,800,-1313.63,RV-order-t,t,2,34,7,7,50
16,800,-1313.63,RV-disorder-t,t,2,11,3,0,16
16,800,-1313.63,RV-order-c,c,6,4,13,2,25
16,800,-1313.63,RV-disorder-c,c,1,0,4,1,6
16,800,-1313.63,RV-order-g,g,0,3,4,13,20
16,800,-1313.63,RV-disorder-g,g,4,2,2,6,14
16,800,-1313.63,RV-O,O,82,23,105
16,800,-1313.63,RV-D,D,9,31,40
17,850,-1311.95,RV-order-a,a,6,4,1,1,12
17,850,-1311.95,RV-disorder-a,a,2,0,0,0,2
17,850,-1311.95,RV-order-t,t,2,34,7,7,50
17,850,-1311.95,RV-disorder-t,t,2,11,3,0,16
17,850,-1311.95,RV-order-c,c,6,4,13,2,25
17,850,-1311.95,RV-disorder-c,c,1,0,4,1,6
17,850,-1311.95,RV-order-g,g,0,3,4,13,20
17,850,-1311.95,RV-disorder-g,g,4,2,2,6,14
17,850,-1311.95,RV-O,O,82,23,105
17,850,-1311.95,RV-D,D,9,31,40
18,900,-1312.13,RV-order-a,a,6,4,1,1,12
18,900,-1312.13,RV-disorder-a,a,2,0,0,0,2
18,900,-1312.13,RV-order-t,t,2,34,7,7,50
18,900,-1312.13,RV-disorder-t,t,2,11,3,0,16
18,900,-1312.13,RV-order-c,c,6,4,13,2,25
18,900,-1312.13,RV-disorder-c,c,1,0,4,1,6
18,900,-1312.13,RV-order-g,g,0,3,4,13,20
18,900,-1312.13,RV-disorder-g,g,4,2,2,6,14
18,900,-1312.13,RV-O,O,82,23,105
18,900,-1312.13,RV-D,D,9,31,40
19,950,-1307.95,RV-order-a,a,6,4,1,1,12
19,950,-1307.95,RV-disorder-a,a,2,0,0,0,2
19,950,-1307.95,RV-order-t,t,2,34,7,7,50
19,950,-1307.95,RV-disorder-t,t,2,11,3,0,16
19,950,-1307.95,RV-order-c,c,6,4,13,2,25
19,950,-1307.95,RV-disorder-c,c,1,0,4,1,6
19,950,-1307.95,RV-order-g,g,0,3,4,13,20
19,950,-1307.95,RV-disorder-g,g,4,2,2,6,14
19,950,-1307.95,RV-O,O,82,23,105
19,950,-1307.95,RV-D,D,9,31,40
20,1000,-1304.57,RV-order-a,a,6,4,1,1,12
20,1000,-1304.57,RV-disorder-a,a,2,0,0,0,2
20,1000,-1304.57,RV-order-t,t,2,34,7,7,50
20,1000,-1304.57,RV-disorder-t,t,2,11,3,0,16
20,1000,-1304.57,RV-order-c,c,6,4,13,2,25
20,1000,-1304.57,RV-disorder-c,c,1,0,4,1,6
20,1000,-1304.57,RV-order-g,g,0,3,4,13,20
20,1000,-1304.57,RV-disorder-g,g,4,2,2,6,14
20,1000,-1304.57,RV-O,O,82,23,105
20,1000,-1304.57,RV-D,D,9,31,40
21,1050,-1349.33,RV-order-a,a,1,1,0,0,2
21,1050,-1349.33,RV-disorder-a,a,11,3,1,1,16
21,1050,-1349.33,RV-order-t,t,3,30,5,3,41
21,1050,-1349.33,RV-disorder-t,t,1,20,5,4,30
21,1050,-1349.33,RV-order-c,c,4,3,13,2,22
21,1050,-1349.33,RV-disorder-c,c,3,1,11,1,16
21,1050,-1349.33,RV-order-g,g,0,4,1,10,15
21,1050,-1349.33,RV-disorder-g,g,4,1,5,13,23
21,1050,-1349.33,RV-O,O,47,10,57
21,1050,-1349.33,RV-D,D,17,70,87
22,1100,-1349.27,RV-order-a,a,1,1,0,0,2
22,1100,-1349.27,RV-disorder-a,a,11,3,1,1,16
22,1100,-1349.27,RV-order-t,t,3,30,5,3,41
22,1100,-1349.27,RV-disorder-t,t,1,20,5,4,30
22,1100,-1349.27,RV-order-c,c,4,3,13,2,22
22,1100,-1349.27,RV-disorder-c,c,3,1,11,1,16
22,1100,-1349.27,RV-order-g,g,0,4,1,10,15
22,1100,-1349.27,RV-disorder-g,g,4,1,5,13,23
22,1100,-1349.27,RV-O,O,47,10,57
22,1100,-1349.27,RV-D,D,17,70,87
23,1150,-1347.75,RV-order-a,a,1,1,0,0,2
23,1150,-1347.75,RV-disorder-a,a,11,3,1,1,16
23,1150,-1347.75,RV-order-t,t,3,30,5,3,41
23,1150,-1347.75,RV-disorder-t,t,1,20,5,4,30
23,1150,-1347.75,RV-order-c,c,4,3,13,2,22
23,1150,-1347.75,RV-disorder-c,c,3,1,11,1,16
23,1150,-1347.75,RV-order-g,g,0,4,1,10,15
23,1150,-1347.75,RV-disorder-g,g,4,1,5,13,23
23,1150,-1347.75,RV-O,O,47,10,57
23,1150,-1347.75,RV-D,D,17,70,87
24,1200,-1348.75,RV-order-a,a,1,1,0,0,2
24,1200,-1348.75,RV-disorder-a,a,11,3,1,1,16
24,1200,-1348.75,RV-order-t,t,3,30,5,3,41
24,1200,-1348.75,RV-disorder-t,t,1,20,5,4,30
24,1200,-1348.75,RV-order-c,c,4,3,13,2,22
24,1200,-1348.75,RV-disorder-c,c,3,1,11,1,16
24,1200,-1348.75,RV-order-g,g,0,4,1,10,15
24,1200,-1348.75,RV-disorder-g,g,4,1,5,13,23
24,1200,-1348.75,RV-O,O,47,10,57
24,1200,-1348.75,RV-D,D,17,70,87
25,1250,-1346.05,RV-order-a,a,1,1,0,0,2
25,1250,-1346.05,RV-disorder-a,a,11,3,1,1,16
25,1250,-1346.05,RV-order-t,t,3,30,5,3,41
25,1250,-1346.05,RV-disorder-t,t,1,20,5,4,30
25,1250,-1346.05,RV-order-c,c,4,3,13,2,22
25,1250,-1346.05,RV-disorder-c,c,3,1,11,1,16
25,1250,-1346.05,RV-order-g,g,0,4,1,10,15
25,1250,-1346.05,RV-disorder-g,g,4,1,5,13,23
25,1250,-1346.05,RV-O,O,47,10,57
25,1250,-1346.05,RV-D,D,17,70,87
26,1300,-1306.22,RV-order-a,a,22,7,2,2,33
26,1300,-1306.22,RV-disorder-a,a,16,0,4,4,24
26,1300,-1306.22,RV-order-t,t,1,25,3,4,33
26,1300,-1306.22,RV-disorder-t,t,3,11,2,2,18
26,1300,-1306.22,RV-order-c,c,0,2,7,0,9
26,1300,-1306.22,RV-disorder-c,c,2,5,24,3,34
26,1300,-1306.22,RV-order-g,g,0,0,1,0,1
26,1300,-1306.22,RV-disorder-g,g,1,4,0,9,14
26,1300,-1306.22,RV-O,O,51,10,61
26,1300,-1306.22,RV-D,D,17,57,74
27,1350,-1303.29,RV-order-a,a,22,7,2,2,33
27,1350,-1303.29,RV-disorder-a,a,16,0,4,4,24
27,1350,-1303.29,RV-order-t,t,1,25,3,4,33
27,1350,-1303.29,RV-disorder-t,t,3,11,2,2,18
27,1350,-1303.29,RV-order-c,c,0,2,7,0,9
27,1350,-1303.29,RV-disorder-c,c,2,5,24,3,34
27,1350,-1303.29,RV-order-g,g,0,0,1,0,1
27,1350,-1303.29,RV-disorder-g,g,1,4,0,9,14
27,1350,-1303.29,RV-O,O,51,10,61
27,1350,-1303.29,RV-D,D,17,57,74
28,1400,-1302.55,RV-order-a,a,22,7,2,2,33
28,1400,-1302.55,RV-disorder-a,a,16,0,4,4,24
28,1400,-1302.55,RV-order-t,t,1,25,3,4,33
28,1400,-1302.55,RV-disorder-t,t,3,11,2,2,18
28,1400,-1302.55,RV-order-c,c,0,2,7,0,9
28,1400,-1302.55,RV-disorder-c,c,2,5,24,3,34
28,1400,-1302.55,RV-order-g,g,0,0,1,0,1
28,1400,-1302.55,RV-disorder-g,g,1,4,0,9,14
28,1400,-1302.55,RV-O,O,51,10,61
28,1400,-1302.55,RV-D,D,17,57,74
29,1450,-1300.37,RV-order-a,a,22,7,2,2,33
29,1450,-1300.37,RV-disorder-a,a,16,0,4,4,24
29,1450,-1300.37,RV-order-t,t,1,25,3,4,33
29,1450,-1300.37,RV-disorder-t,t,3,11,2,2,18
29,1450,-1300.37,RV-order-c,c,0,2,7,0,9
29,1450,-1300.37,RV-disorder-c,c,2,5,24,3,34
29,1450,-1300.37,RV-order-g,g,0,0,1,0,1
29,1450,-1300.37,RV-disorder-g,g,1,4,0,9,14
29,1450,-1300.37,RV-O,O,51,10,61
29,1450,-1300.37,RV-D,D,17,57,74
30,1500,-1298.38,RV-order-a,a,22,7,2,2,33
30,1500,-1298.38,RV-disorder-a,a,16,0,4,4,24
30,1500,-1298.38,RV-order-t,t,1,25,3,4,33
30,1500,-1298.38,RV-disorder-t,t,3,11,2,2,18
30,1500,-1298.38,RV-order-c,c,0,2,7,0,9
30,1500,-1298.38,RV-disorder-c,c,2,5,24,3,34
30,1500,-1298.38,RV-order-g,g,0,0,1,0,1
30,1500,-1298.38,RV-disorder-g,g,1,4,0,9,14
30,1500,-1298.38,RV-O,O,51,10,61
30,1500,-1298.38,RV-D,D,17,57,74
31,1550,-1302.18,RV-order-a,a,14,5,4,4,27
31,1550,-1302.18,RV-disorder-a,a,15,2,2,2,21
31,1550,-1302.18,RV-order-t,t,4,31,3,3,41
31,1550,-1302.18,RV-disorder-t,t,0,7,2,3,12
31,1550,-1302.18,RV-order-c,c,2,5,14,3,24
31,1550,-1302.18,RV-disorder-c,c,0,2,7,0,9
31,1550,-1302.18,RV-order-g,g,1,4,0,12,17
31,1550,-1302.18,RV-disorder-g,g,0,0,1,1,2
31,1550,-1302.18,RV-O,O,75,22,97
31,1550,-1302.18,RV-D,D,12,32,44
32,1600,-1300.9,RV-order-a,a,14,5,4,4,27
32,1600,-1300.9,RV-disorder-a,a,15,2,2,2,21
32,1600,-1300.9,RV-order-t,t,4,31,3,3,41
32,1600,-1300.9,RV-disorder-t,t,0,7,2,3,12
32,1600,-1300.9,RV-order-c,c,2,5,14,3,24
32,1600,-1300.9,RV-disorder-c,c,0,2,7,0,9
32,1600,-1300.9,RV-order-g,g,1,4,0,12,17
32,1600,-1300.9,RV-disorder-g,g,0,0,1,1,2
32,1600,-1300.9,RV-O,O,75,22,97
32,1600,-1300.9,RV-D,D,12,32,44
33,1650,-1299.06,RV-order-a,a,14,5,4,4,27
33,1650,-1299.06,RV-disorder-a,a,15,2,2,2,21
33,1650,-1299.06,RV-order-t,t,4,31,3,3,41
33,1650,-1299.06,RV-disorder-t,t,0,7,2,3,12
33,1650,-1299.06,RV-order-c,c,2,5,14,3,24
33,1650,-1299.06,RV-disorder-c,c,0,2,7,0,9
33,1650,-1299.06,RV-order-g,g,1,4,0,12,17
33,1650,-1299.06,RV-disorder-g,g,0,0,1,1,2
33,1650,-1299.06,RV-O,O,75,22,97
33,1650,-1299.06,RV-D,D,12,32,44
34,1700,-1296.98,RV-order-a,a,14,5,4,4,27
34,1700,-1296.98,RV-disorder-a,a,15,2,2,2,21
34,1700,-1296.98,RV-order-t,t,4,31,3,3,41
34,1700,-1296.98,RV-disorder-t,t,0,7,2,3,12
34,1700,-1296.98,RV-order-c,c,2,5,14,3,24
34,1700,-1296.98,RV-disorder-c,c,0,2,7,0,9
34,1700,-1296.98,RV-order-g,g,1,4,0,12,17
34,1700,-1296.98,RV-disorder-g,g,0,0,1,1,2
34,1700,-1296.98,RV-O,O,75,22,97
34,1700,-1296.98,RV-D,D,12,32,44
35,1750,-1291.38,RV-order-a,a,14,5,4,4,27
35,1750,-1291.38,RV-disorder-a,a,15,2,2,2,21
35,1750,-1291.38,RV-order-t,t,4,31,3,3,41
35,1750,-1291.38,RV-disorder-t,t,0,7,2,3,12
35,1750,-1291.38,RV-order-c,c,2,5,14,3,24
35,1750,-1291.38,RV-disorder-c,c,0,2,7,0,9
35,1750,-1291.38,RV-order-g,g,1,4,0,12,17
35,1750,-1291.38,RV-disorder-g,g,0,0,1,1,2
35,1750,-1291.38,RV-O,O,75,22,97
35,1750,-1291.38,RV-D,D,12,32,44
36,1800,-1379.33,RV-order-a,a,20,6,1,3,30
36,1800,-1379.33,RV-disorder-a,a,0,0,0,0,0
36,1800,-1379.33,RV-order-t,t,1,20,5,4,30
36,1800,-1379.33,RV-disorder-t,t,2,12,3,1,18
36,1800,-1379.33,RV-order-c,c,3,5,11,1,20
36,1800,-1379.33,RV-disorder-c,c,5,3,18,3,29
36,1800,-1379.33,RV-order-g,g,2,3,6,16,27
36,1800,-1379.33,RV-disorder-g,g,0,1,0,2,3
36,1800,-1379.33,RV-O,O,86,22,108
36,1800,-1379.33,RV-D,D,12,39,51
37,1850,-1377.3,RV-order-a,a,20,6,1,3,30
37,1850,-1377.3,RV-disorder-a,a,0,0,0,0,0
37,1850,-1377.3,RV-order-t,t,1,20,5,4,30
37,1850,-1377.3,RV-disorder-t,t,2,12,3,1,18
37,1850,-1377.3,RV-order-c,c,3,5,11,1,20
37,1850,-1377.3,RV-disorder-c,c,5,3,18,3,29
37,1850,-1377.3,RV-order-g,g,2,3,6,16,27
37,1850,-1377.3,RV-disorder-g,g,0,1,0,2,3
37,1850,-1377.3,RV-O,O,86,22,108
37,1850,-1377.3,RV-D,D,12,39,51
38,1900,-1378.84,RV-order-a,a,20,6,1,3,30
38,1900,-1378.84,RV-disorder-a,a,0,0,0,0,0
38,1900,-1378.84,RV-order-t,t,1,20,5,4,30
38,1900,-1378.84,RV-disorder-t,t,2,12,3,1,18
38,1900,-1378.84,RV-order-c,c,3,5,11,1,20
38,1900,-1378.84,RV-disorder-c,c,5,3,18,3,29
38,1900,-1378.84,RV-order-g,g,2,3,6,16,27
38,1900,-1378.84,RV-disorder-g,g,0,1,0,2,3
38,1900,-1378.84,RV-O,O,86,22,108
38,1900,-1378.84,RV-D,D,12,39,51
39,1950,-1378.55,RV-order-a,a,20,6,1,3,30
39,1950,-1378.55,RV-disorder-a,a,0,0,0,0,0
39,1950,-1378.55,RV-order-t,t,1,20,5,4,30
39,1950,-1378.55,RV-disorder-t,t,2,12,3,1,18
39,1950,-1378.55,RV-order-c,c,3,5,11,1,20
39,1950,-1378.55,RV-disorder-c,c,5,3,18,3,29
39,1950,-1378.55,RV-order-g,g,2,3,6,16,27
39,1950,-1378.55,RV-disorder-g,g,0,1,0,2,3
39,1950,-1378.55,RV-O,O,86,22,108
39,1950,-1378.55,RV-D,D,12,39,51
40,2000,-1378.78,RV-order-a,a,20,6,1,3,30
40,2000,-1378.78,RV-disorder-a,a,0,0,0,0,0
40,2000,-1378.78,RV-order-t,t,1,20,5,4,30
40,2000,-1378.78,RV-disorder-t,t,2,12,3,1,18
40,2000,-1378.78,RV-order-c,c,3,5,11,1,20
40,2000,-1378.78,RV-disorder-c,c,5,3,18,3,29
40,2000,-1378.78,RV-order-g,g,2,3,6,16,27
40,2000,-1378.78,RV-disorder-g,g,0,1,0,2,3
40,2000,-1378.78,RV-O,O,86,22,108
40,2000,-1378.78,RV-D,D,12,39,51
