I,GEN,LogL,RateVector,State,a,c,g,t,Total
0,0,-1127.36,RV-a,a,32,4,2,5,43
0,0,-1127.36,RV-c,c,1,10,2,2,15
0,0,-1127.36,RV-g,g,3,1,10,1,15
0,0,-1127.36,RV-t,t,5,11,9,56,81
1,100,-1082.75,RV-a,a,32,4,2,5,43
1,100,-1082.75,RV-c,c,1,10,2,2,15
1,100,-1082.75,RV-g,g,3,1,10,1,15
1,100,-1082.75,RV-t,t,5,11,9,56,81
2,200,-1024.26,RV-a,a,32,4,2,5,43
2,200,-1024.26,RV-c,c,1,10,2,2,15
2,200,-1024.26,RV-g,g,3,1,10,1,15
2,200,-1024.26,RV-t,t,5,11,9,56,81
3,300,-1052.04,RV-a,a,29,4,3,3,39
3,300,-1052.04,RV-c,c,2,17,2,3,24
3,300,-1052.04,RV-g,g,2,1,6,1,10
3,300,-1052.04,RV-t,t,7,10,8,71,96
4,400,-1035.31,RV-a,a,29,4,3,3,39
4,400,-1035.31,RV-c,c,2,17,2,3,24
4,400,-1035.31,RV-g,g,2,1,6,1,10
4,400,-1035.31,RV-t,t,7,10,8,71,96
5,500,-999.012,RV-a,a,26,4,3,3,36
5,500,-999.012,RV-c,c,1,19,2,4,26
5,500,-999.012,RV-g,g,2,1,6,0,9
5,500,-999.012,RV-t,t,8,9,9,62,88
6,600,-988.721,RV-a,a,26,4,3,3,36
6,600,-988.721,RV-c,c,1,19,2,4,26
6,600,-988.721,RV-g,g,2,1,6,0,9
6,600,-988.721,RV-t,t,8,9,9,62,88
7,700,-968.622,RV-a,a,27,5,3,2,37
7,700,-968.622,RV-c,c,1,17,2,5,25
7,700,-968.622,RV-g,g,1,0,2,0,3
7,700,-968.622,RV-t,t,10,8,9,65,92
8,800,-963.783,RV-a,a,27,5,3,2,37
8,800,-963.783,RV-c,c,1,17,2,5,25
8,800,-963.783,RV-g,g,1,0,2,0,3
8,800,-963.783,RV-t,t,10,8,9,65,92
9,900,-975.293,RV-a,a,28,4,3,3,38
9,900,-975.293,RV-c,c,1,19,2,5,27
9,900,-975.293,RV-g,g,1,1,5,0,7
9,900,-975.293,RV-t,t,9,8,9,64,90
10,1000,-973.586,RV-a,a,28,4,3,3,38
10,1000,-973.586,RV-c,c,1,19,2,5,27
10,1000,-973.586,RV-g,g,1,1,5,0,7
10,1000,-973.586,RV-t,t,9,8,9,64,90
