I,GEN,LogL,RateVector,State,a,t,c,g,Total
0,0,-1725.4,RV-order-a,a,21,4,2,3,30
0,0,-1725.4,RV-disorder-a,a,8,1,2,1,12
0,0,-1725.4,RV-order-t,t,6,24,6,3,39
0,0,-1725.4,RV-disorder-t,t,0,14,5,3,22
0,0,-1725.4,RV-order-c,c,1,5,19,5,30
0,0,-1725.4,RV-disorder-c,c,2,1,7,1,11
0,0,-1725.4,RV-order-g,g,1,6,0,12,19
0,0,-1725.4,RV-disorder-g,g,0,2,1,5,8
0,0,-1725.4,RV-O,O,86,21,107
0,0,-1725.4,RV-D,D,20,22,42
1,100,-1599.4,RV-order-a,a,21,4,2,3,30
1,100,-1599.4,RV-disorder-a,a,8,1,2,1,12
1,100,-1599.4,RV-order-t,t,6,24,6,3,39
1,100,-1599.4,RV-disorder-t,t,0,14,5,3,22
1,100,-1599.4,RV-order-c,c,1,5,19,5,30
1,100,-1599.4,RV-disorder-c,c,2,1,7,1,11
1,100,-1599.4,RV-order-g,g,1,6,0,12,19
1,100,-1599.4,RV-disorder-g,g,0,2,1,5,8
1,100,-1599.4,RV-O,O,86,21,107
1,100,-1599.4,RV-D,D,20,22,42
2,200,-1552.28,RV-order-a,a,21,4,2,3,30
2,200,-1552.28,RV-disorder-a,a,8,1,2,1,12
2,200,-1552.28,RV-order-t,t,6,24,6,3,39
2,200,-1552.28,RV-disorder-t,t,0,14,5,3,22
2,200,-1552.28,RV-order-c,c,1,5,19,5,30
2,200,-1552.28,RV-disorder-c,c,2,1,7,1,11
2,200,-1552.28,RV-order-g,g,1,6,0,12,19
2,200,-1552.28,RV-disorder-g,g,0,2,1,5,8
2,200,-1552.28,RV-O,O,86,21,107
2,200,-1552.28,RV-D,D,20,22,42
3,300,-1358.19,RV-order-a,a,16,2,1,2,21
3,300,-1358.19,RV-disorder-a,a,13,1,2,4,20
3,300,-1358.19,RV-order-t,t,4,21,5,2,32
3,300,-1358.19,RV-disorder-t,t,0,14,0,5,19
3,300,-1358.19,RV-order-c,c,1,5,14,2,22
3,300,-1358.19,RV-disorder-c,c,0,2,8,1,11
3,300,-1358.19,RV-order-g,g,2,1,0,4,7
3,300,-1358.19,RV-disorder-g,g,2,2,4,9,17
3,300,-1358.19,RV-O,O,63,17,80
3,300,-1358.19,RV-D,D,15,52,67
4,400,-1340.32,RV-order-a,a,16,2,1,2,21
4,400,-1340.32,RV-disorder-a,a,13,1,2,4,20
4,400,-1340.32,RV-order-t,t,4,21,5,2,32
4,400,-1340.32,RV-disorder-t,t,0,14,0,5,19
4,400,-1340.32,RV-order-c,c,1,5,14,2,22
4,400,-1340.32,RV-disorder-c,c,0,2,8,1,11
4,400,-1340.32,RV-order-g,g,2,1,0,4,7
4,400,-1340.32,RV-disorder-g,g,2,2,4,9,17
4,400,-1340.32,RV-O,O,63,17,80
4,400,-1340.32,RV-D,D,15,52,67
5,500,-1329.61,RV-order-a,a,16,2,1,2,21
5,500,-1329.61,RV-disorder-a,a,13,1,2,4,20
5,500,-1329.61,RV-order-t,t,4,21,5,2,32
5,500,-1329.61,RV-disorder-t,t,0,14,0,5,19
5,500,-1329.61,RV-order-c,c,1,5,14,2,22
5,500,-1329.61,RV-disorder-c,c,0,2,8,1,11
5,500,-1329.61,RV-order-g,g,2,1,0,4,7
5,500,-1329.61,RV-disorder-g,g,2,2,4,9,17
5,500,-1329.61,RV-O,O,63,17,80
5,500,-1329.61,RV-D,D,15,52,67
6,600,-1367.19,RV-order-a,a,14,3,1,2,20
6,600,-1367.19,RV-disorder-a,a,10,1,3,4,18
6,600,-1367.19,RV-order-t,t,3,30,4,4,41
6,600,-1367.19,RV-disorder-t,t,1,13,0,2,16
6,600,-1367.19,RV-order-c,c,1,5,16,3,25
6,600,-1367.19,RV-disorder-c,c,0,2,8,1,11
6,600,-1367.19,RV-order-g,g,1,0,1,3,5
6,600,-1367.19,RV-disorder-g,g,3,3,2,8,16
6,600,-1367.19,RV-O,O,74,19,93
6,600,-1367.19,RV-D,D,12,56,68
7,700,-1362.75,RV-order-a,a,14,3,1,2,20
7,700,-1362.75,RV-disorder-a,a,10,1,3,4,18
7,700,-1362.75,RV-order-t,t,3,30,4,4,41
7,700,-1362.75,RV-disorder-t,t,1,13,0,2,16
7,700,-1362.75,RV-order-c,c,1,5,16,3,25
7,700,-1362.75,RV-disorder-c,c,0,2,8,1,11
7,700,-1362.75,RV-order-g,g,1,0,1,3,5
7,700,-1362.75,RV-disorder-g,g,3,3,2,8,16
7,700,-1362.75,RV-O,O,74,19,93
7,700,-1362.75,RV-D,D,12,56,68
8,800,-1364.74,RV-order-a,a,18,4,1,3,26
8,800,-1364.74,RV-disorder-a,a,15,0,3,4,22
8,800,-1364.74,RV-order-t,t,4,28,4,2,38
8,800,-1364.74,RV-disorder-t,t,1,16,1,5,23
8,800,-1364.74,RV-order-c,c,1,5,16,2,24
8,800,-1364.74,RV-disorder-c,c,0,2,11,1,14
8,800,-1364.74,RV-order-g,g,0,0,0,3,3
8,800,-1364.74,RV-disorder-g,g,2,1,2,13,18
8,800,-1364.74,RV-O,O,64,19,83
8,800,-1364.74,RV-D,D,14,48,62
9,900,-1362.33,RV-order-a,a,18,4,1,3,26
9,900,-1362.33,RV-disorder-a,a,15,0,3,4,22
9,900,-1362.33,RV-order-t,t,4,28,4,2,38
9,900,-1362.33,RV-disorder-t,t,1,16,1,5,23
9,900,-1362.33,RV-order-c,c,1,5,16,2,24
9,900,-1362.33,RV-disorder-c,c,0,2,11,1,14
9,900,-1362.33,RV-order-g,g,0,0,0,3,3
9,900,-1362.33,RV-disorder-g,g,2,1,2,13,18
9,900,-1362.33,RV-O,O,64,19,83
9,900,-1362.33,RV-D,D,14,48,62
10,1000,-1354.34,RV-order-a,a,18,4,1,3,26
10,1000,-1354.34,RV-disorder-a,a,15,0,3,4,22
10,1000,-1354.34,RV-order-t,t,4,28,4,2,38
10,1000,-1354.34,RV-disorder-t,t,1,16,1,5,23
10,1000,-1354.34,RV-order-c,c,1,5,16,2,24
10,1000,-1354.34,RV-disorder-c,c,0,2,11,1,14
10,1000,-1354.34,RV-order-g,g,0,0,0,3,3
10,1000,-1354.34,RV-disorder-g,g,2,1,2,13,18
10,1000,-1354.34,RV-O,O,64,19,83
10,1000,-1354.34,RV-D,D,14,48,62
