I,GEN,LogL,RateVector,State,a,t,c,g,Total
0,0,-1257.92,RV-a,a,13,5,2,3,23
0,0,-1257.92,RV-a,a,4,0,0,0,4
0,0,-1257.92,RV-t,t,1,12,6,4,23
0,0,-1257.92,RV-t,t,0,5,0,2,7
0,0,-1257.92,RV-c,c,6,5,9,3,23
0,0,-1257.92,RV-c,c,0,2,5,1,8
0,0,-1257.92,RV-g,g,1,7,5,10,23
0,0,-1257.92,RV-g,g,1,1,1,1,4
0,0,-1257.92,RV-O,O,56,28,84
0,0,-1257.92,RV-D,D,12,9,21
1,100,-1146.15,RV-a,a,6,4,1,2,13
1,100,-1146.15,RV-a,a,7,1,1,1,10
1,100,-1146.15,RV-t,t,1,13,4,4,22
1,100,-1146.15,RV-t,t,0,7,2,2,11
1,100,-1146.15,RV-c,c,4,6,10,0,20
1,100,-1146.15,RV-c,c,2,1,1,4,8
1,100,-1146.15,RV-g,g,1,6,4,7,18
1,100,-1146.15,RV-g,g,1,2,2,7,12
1,100,-1146.15,RV-O,O,53,16,69
1,100,-1146.15,RV-D,D,10,30,40
2,200,-1079.8,RV-a,a,14,3,2,2,21
2,200,-1079.8,RV-a,a,5,0,2,2,9
2,200,-1079.8,RV-t,t,4,19,3,6,32
2,200,-1079.8,RV-t,t,3,11,1,2,17
2,200,-1079.8,RV-c,c,1,6,10,1,18
2,200,-1079.8,RV-c,c,0,1,10,3,14
2,200,-1079.8,RV-g,g,0,0,1,1,2
2,200,-1079.8,RV-g,g,0,2,1,5,8
2,200,-1079.8,RV-O,O,49,16,65
2,200,-1079.8,RV-D,D,10,30,40
3,300,-983.217,RV-a,a,10,3,2,2,17
3,300,-983.217,RV-a,a,5,0,2,2,9
3,300,-983.217,RV-t,t,4,20,3,6,33
3,300,-983.217,RV-t,t,3,7,1,2,13
3,300,-983.217,RV-c,c,1,5,9,2,17
3,300,-983.217,RV-c,c,0,2,9,2,13
3,300,-983.217,RV-g,g,0,1,1,1,3
3,300,-983.217,RV-g,g,0,1,1,3,5
3,300,-983.217,RV-O,O,42,17,59
3,300,-983.217,RV-D,D,9,20,29
4,400,-1042.42,RV-a,a,11,2,2,1,16
4,400,-1042.42,RV-a,a,9,0,3,3,15
4,400,-1042.42,RV-t,t,4,22,6,7,39
4,400,-1042.42,RV-t,t,2,8,0,2,12
4,400,-1042.42,RV-c,c,1,3,6,0,10
4,400,-1042.42,RV-c,c,0,2,5,0,7
4,400,-1042.42,RV-g,g,1,2,1,4,8
4,400,-1042.42,RV-g,g,1,1,2,5,9
4,400,-1042.42,RV-O,O,51,17,68
4,400,-1042.42,RV-D,D,9,27,36
5,500,-1026.39,RV-a,a,9,2,2,1,14
5,500,-1026.39,RV-a,a,6,0,3,3,12
5,500,-1026.39,RV-t,t,4,26,5,6,41
5,500,-1026.39,RV-t,t,2,6,1,3,12
5,500,-1026.39,RV-c,c,1,4,3,0,8
5,500,-1026.39,RV-c,c,0,1,3,0,4
5,500,-1026.39,RV-g,g,1,2,1,4,8
5,500,-1026.39,RV-g,g,1,1,2,5,9
5,500,-1026.39,RV-O,O,56,16,72
5,500,-1026.39,RV-D,D,10,28,38
6,600,-968.602,RV-a,a,8,2,2,0,12
6,600,-968.602,RV-a,a,12,1,3,4,20
6,600,-968.602,RV-t,t,5,13,4,6,28
6,600,-968.602,RV-t,t,1,8,0,1,10
6,600,-968.602,RV-c,c,1,7,9,2,19
6,600,-968.602,RV-c,c,0,1,5,3,9
6,600,-968.602,RV-g,g,1,1,0,4,6
6,600,-968.602,RV-g,g,0,1,0,3,4
6,600,-968.602,RV-O,O,43,16,59
6,600,-968.602,RV-D,D,10,23,33
7,700,-980.438,RV-a,a,8,2,2,0,12
7,700,-980.438,RV-a,a,7,1,3,4,15
7,700,-980.438,RV-t,t,4,12,4,3,23
7,700,-980.438,RV-t,t,2,13,0,4,19
7,700,-980.438,RV-c,c,1,6,11,2,20
7,700,-980.438,RV-c,c,0,2,9,3,14
7,700,-980.438,RV-g,g,1,0,0,1,2
7,700,-980.438,RV-g,g,0,2,0,3,5
7,700,-980.438,RV-O,O,35,12,47
7,700,-980.438,RV-D,D,14,33,47
8,800,-996.222,RV-a,a,7,1,3,0,11
8,800,-996.222,RV-a,a,5,0,2,1,8
8,800,-996.222,RV-t,t,3,13,6,2,24
8,800,-996.222,RV-t,t,2,12,1,5,20
8,800,-996.222,RV-c,c,1,3,9,2,15
8,800,-996.222,RV-c,c,0,2,5,3,10
8,800,-996.222,RV-g,g,2,1,0,1,4
8,800,-996.222,RV-g,g,2,3,1,9,15
8,800,-996.222,RV-O,O,43,12,55
8,800,-996.222,RV-D,D,14,35,49
9,900,-991.171,RV-a,a,13,1,3,0,17
9,900,-991.171,RV-a,a,6,0,2,1,9
9,900,-991.171,RV-t,t,3,16,6,4,29
9,900,-991.171,RV-t,t,2,7,1,3,13
9,900,-991.171,RV-c,c,1,2,4,3,10
9,900,-991.171,RV-c,c,0,3,7,2,12
9,900,-991.171,RV-g,g,3,1,0,4,8
9,900,-991.171,RV-g,g,1,3,1,7,12
9,900,-991.171,RV-O,O,40,13,53
9,900,-991.171,RV-D,D,13,34,47
10,1000,-996.391,RV-a,a,4,1,3,1,9
10,1000,-996.391,RV-a,a,6,0,2,2,10
10,1000,-996.391,RV-t,t,6,10,1,4,21
10,1000,-996.391,RV-t,t,3,14,0,4,21
10,1000,-996.391,RV-c,c,1,8,11,4,24
10,1000,-996.391,RV-c,c,0,3,13,2,18
10,1000,-996.391,RV-g,g,0,0,0,1,1
10,1000,-996.391,RV-g,g,0,1,0,4,5
10,1000,-996.391,RV-O,O,43,13,56
10,1000,-996.391,RV-D,D,13,36,49
