I,GEN,LogL,RateVector,State,a,t,c,g,Total
0,0,-1732.08,RV-order-a,a,12,1,1,0,14
0,0,-1732.08,RV-disorder-a,a,5,0,1,1,7
0,0,-1732.08,RV-order-t,t,3,27,3,5,38
0,0,-1732.08,RV-disorder-t,t,2,13,3,0,18
0,0,-1732.08,RV-order-c,c,1,6,17,2,26
0,0,-1732.08,RV-disorder-c,c,3,3,10,2,18
0,0,-1732.08,RV-order-g,g,6,4,3,10,23
0,0,-1732.08,RV-disorder-g,g,2,3,3,11,19
0,0,-1732.08,RV-O,O,85,17,102
0,0,-1732.08,RV-D,D,22,45,67
1,100,-1599.46,RV-order-a,a,12,1,1,0,14
1,100,-1599.46,RV-disorder-a,a,5,0,1,1,7
1,100,-1599.46,RV-order-t,t,3,27,3,5,38
1,100,-1599.46,RV-disorder-t,t,2,13,3,0,18
1,100,-1599.46,RV-order-c,c,1,6,17,2,26
1,100,-1599.46,RV-disorder-c,c,3,3,10,2,18
1,100,-1599.46,RV-order-g,g,6,4,3,10,23
1,100,-1599.46,RV-disorder-g,g,2,3,3,11,19
1,100,-1599.46,RV-O,O,85,17,102
1,100,-1599.46,RV-D,D,22,45,67
2,200,-1559.82,RV-order-a,a,12,1,1,0,14
2,200,-1559.82,RV-disorder-a,a,5,0,1,1,7
2,200,-1559.82,RV-order-t,t,3,27,3,5,38
2,200,-1559.82,RV-disorder-t,t,2,13,3,0,18
2,200,-1559.82,RV-order-c,c,1,6,17,2,26
2,200,-1559.82,RV-disorder-c,c,3,3,10,2,18
2,200,-1559.82,RV-order-g,g,6,4,3,10,23
2,200,-1559.82,RV-disorder-g,g,2,3,3,11,19
2,200,-1559.82,RV-O,O,85,17,102
2,200,-1559.82,RV-D,D,22,45,67
3,300,-1456.99,RV-order-a,a,14,5,2,1,22
3,300,-1456.99,RV-disorder-a,a,15,1,4,2,22
3,300,-1456.99,RV-order-t,t,6,26,5,5,42
3,300,-1456.99,RV-disorder-t,t,1,15,2,2,20
3,300,-1456.99,RV-order-c,c,0,4,8,3,15
3,300,-1456.99,RV-disorder-c,c,0,1,12,2,15
3,300,-1456.99,RV-order-g,g,1,2,1,4,8
3,300,-1456.99,RV-disorder-g,g,2,3,2,12,19
3,300,-1456.99,RV-O,O,71,23,94
3,300,-1456.99,RV-D,D,15,40,55
4,400,-1443.92,RV-order-a,a,14,5,2,1,22
4,400,-1443.92,RV-disorder-a,a,15,1,4,2,22
4,400,-1443.92,RV-order-t,t,6,26,5,5,42
4,400,-1443.92,RV-disorder-t,t,1,15,2,2,20
4,400,-1443.92,RV-order-c,c,0,4,8,3,15
4,400,-1443.92,RV-disorder-c,c,0,1,12,2,15
4,400,-1443.92,RV-order-g,g,1,2,1,4,8
4,400,-1443.92,RV-disorder-g,g,2,3,2,12,19
4,400,-1443.92,RV-O,O,71,23,94
4,400,-1443.92,RV-D,D,15,40,55
5,500,-1426.04,RV-order-a,a,14,5,2,1,22
5,500,-1426.04,RV-disorder-a,a,15,1,4,2,22
5,500,-1426.04,RV-order-t,t,6,26,5,5,42
5,500,-1426.04,RV-disorder-t,t,1,15,2,2,20
5,500,-1426.04,RV-order-c,c,0,4,8,3,15
5,500,-1426.04,RV-disorder-c,c,0,1,12,2,15
5,500,-1426.04,RV-order-g,g,1,2,1,4,8
5,500,-1426.04,RV-disorder-g,g,2,3,2,12,19
5,500,-1426.04,RV-O,O,71,23,94
5,500,-1426.04,RV-D,D,15,40,55
6,600,-1484.42,RV-order-a,a,14,6,3,3,26
6,600,-1484.42,RV-disorder-a,a,14,1,3,3,21
6,600,-1484.42,RV-order-t,t,2,27,6,5,40
6,600,-1484.42,RV-disorder-t,t,1,18,0,1,20
6,600,-1484.42,RV-order-c,c,3,4,13,1,21
6,600,-1484.42,RV-disorder-c,c,0,3,6,1,10
6,600,-1484.42,RV-order-g,g,3,3,2,5,13
6,600,-1484.42,RV-disorder-g,g,2,2,3,7,14
6,600,-1484.42,RV-O,O,63,26,89
6,600,-1484.42,RV-D,D,14,57,71
7,700,-1477.9,RV-order-a,a,14,6,3,3,26
7,700,-1477.9,RV-disorder-a,a,14,1,3,3,21
7,700,-1477.9,RV-order-t,t,2,27,6,5,40
7,700,-1477.9,RV-disorder-t,t,1,18,0,1,20
7,700,-1477.9,RV-order-c,c,3,4,13,1,21
7,700,-1477.9,RV-disorder-c,c,0,3,6,1,10
7,700,-1477.9,RV-order-g,g,3,3,2,5,13
7,700,-1477.9,RV-disorder-g,g,2,2,3,7,14
7,700,-1477.9,RV-O,O,63,26,89
7,700,-1477.9,RV-D,D,14,57,71
8,800,-1339.62,RV-order-a,a,16,4,1,2,23
8,800,-1339.62,RV-disorder-a,a,16,0,3,3,22
8,800,-1339.62,RV-order-t,t,4,27,6,4,41
8,800,-1339.62,RV-disorder-t,t,2,13,1,2,18
8,800,-1339.62,RV-order-c,c,2,6,12,4,24
8,800,-1339.62,RV-disorder-c,c,0,2,7,0,9
8,800,-1339.62,RV-order-g,g,0,0,1,2,3
8,800,-1339.62,RV-disorder-g,g,2,2,3,10,17
8,800,-1339.62,RV-O,O,57,20,77
8,800,-1339.62,RV-D,D,15,50,65
9,900,-1336.25,RV-order-a,a,16,4,1,2,23
9,900,-1336.25,RV-disorder-a,a,16,0,3,3,22
9,900,-1336.25,RV-order-t,t,4,27,6,4,41
9,900,-1336.25,RV-disorder-t,t,2,13,1,2,18
9,900,-1336.25,RV-order-c,c,2,6,12,4,24
9,900,-1336.25,RV-disorder-c,c,0,2,7,0,9
9,900,-1336.25,RV-order-g,g,0,0,1,2,3
9,900,-1336.25,RV-disorder-g,g,2,2,3,10,17
9,900,-1336.25,RV-O,O,57,20,77
9,900,-1336.25,RV-D,D,15,50,65
10,1000,-1332.41,RV-order-a,a,16,4,1,2,23
10,1000,-1332.41,RV-disorder-a,a,16,0,3,3,22
10,1000,-1332.41,RV-order-t,t,4,27,6,4,41
10,1000,-1332.41,RV-disorder-t,t,2,13,1,2,18
10,1000,-1332.41,RV-order-c,c,2,6,12,4,24
10,1000,-1332.41,RV-disorder-c,c,0,2,7,0,9
10,1000,-1332.41,RV-order-g,g,0,0,1,2,3
10,1000,-1332.41,RV-disorder-g,g,2,2,3,10,17
10,1000,-1332.41,RV-O,O,57,20,77
10,1000,-1332.41,RV-D,D,15,50,65
