I,GEN,LogL,RateVector,State,a,t,c,g,Total
0,0,-1735.07,RV-order-a,a,19,3,1,1,24
0,0,-1735.07,RV-disorder-a,a,6,0,3,0,9
0,0,-1735.07,RV-order-t,t,2,23,3,6,34
0,0,-1735.07,RV-disorder-t,t,0,6,0,2,8
0,0,-1735.07,RV-order-c,c,1,8,23,3,35
0,0,-1735.07,RV-disorder-c,c,1,3,6,1,11
0,0,-1735.07,RV-order-g,g,4,6,1,17,28
0,0,-1735.07,RV-disorder-g,g,5,1,3,11,20
0,0,-1735.07,RV-O,O,80,22,102
0,0,-1735.07,RV-D,D,18,42,60
1,50,-1593.14,RV-order-a,a,11,2,1,1,15
1,50,-1593.14,RV-disorder-a,a,9,1,3,0,13
1,50,-1593.14,RV-order-t,t,1,17,1,3,22
1,50,-1593.14,RV-disorder-t,t,1,18,2,5,26
1,50,-1593.14,RV-order-c,c,1,5,10,0,16
1,50,-1593.14,RV-disorder-c,c,1,6,22,4,33
1,50,-1593.14,RV-order-g,g,5,3,2,6,16
1,50,-1593.14,RV-disorder-g,g,4,4,2,17,27
1,50,-1593.14,RV-O,O,61,10,71
1,50,-1593.14,RV-D,D,21,66,87
2,100,-1557.95,RV-order-a,a,11,2,1,1,15
2,100,-1557.95,RV-disorder-a,a,9,1,3,0,13
2,100,-1557.95,RV-order-t,t,1,17,1,3,22
2,100,-1557.95,RV-disorder-t,t,1,18,2,5,26
2,100,-1557.95,RV-order-c,c,1,5,10,0,16
2,100,-1557.95,RV-disorder-c,c,1,6,22,4,33
2,100,-1557.95,RV-order-g,g,5,3,2,6,16
2,100,-1557.95,RV-disorder-g,g,4,4,2,17,27
2,100,-1557.95,RV-O,O,61,10,71
2,100,-1557.95,RV-D,D,21,66,87
3,150,-1520.66,RV-order-a,a,11,2,1,1,15
3,150,-1520.66,RV-disorder-a,a,9,1,3,0,13
3,150,-1520.66,RV-order-t,t,1,17,1,3,22
3,150,-1520.66,RV-disorder-t,t,1,18,2,5,26
3,150,-1520.66,RV-order-c,c,1,5,10,0,16
3,150,-1520.66,RV-disorder-c,c,1,6,22,4,33
3,150,-1520.66,RV-order-g,g,5,3,2,6,16
3,150,-1520.66,RV-disorder-g,g,4,4,2,17,27
3,150,-1520.66,RV-O,O,61,10,71
3,150,-1520.66,RV-D,D,21,66,87
4,200,-1510.97,RV-order-a,a,11,2,1,1,15
4,200,-1510.97,RV-disorder-a,a,9,1,3,0,13
4,200,-1510.97,RV-order-t,t,1,17,1,3,22
4,200,-1510.97,RV-disorder-t,t,1,18,2,5,26
4,200,-1510.97,RV-order-c,c,1,5,10,0,16
4,200,-1510.97,RV-disorder-c,c,1,6,22,4,33
4,200,-1510.97,RV-order-g,g,5,3,2,6,16
4,200,-1510.97,RV-disorder-g,g,4,4,2,17,27
4,200,-1510.97,RV-O,O,61,10,71
4,200,-1510.97,RV-D,D,21,66,87
5,250,-1489.93,RV-order-a,a,22,3,2,2,29
5,250,-1489.93,RV-disorder-a,a,13,1,3,3,20
5,250,-1489.93,RV-order-t,t,3,10,0,2,15
5,250,-1489.93,RV-disorder-t,t,3,27,4,3,37
5,250,-1489.93,RV-order-c,c,1,4,12,0,17
5,250,-1489.93,RV-disorder-c,c,2,2,8,3,15
5,250,-1489.93,RV-order-g,g,0,3,1,6,10
5,250,-1489.93,RV-disorder-g,g,0,5,6,16,27
5,250,-1489.93,RV-O,O,56,10,66
5,250,-1489.93,RV-D,D,21,70,91
6,300,-1478.15,RV-order-a,a,22,3,2,2,29
6,300,-1478.15,RV-disorder-a,a,13,1,3,3,20
6,300,-1478.15,RV-order-t,t,3,10,0,2,15
6,300,-1478.15,RV-disorder-t,t,3,27,4,3,37
6,300,-1478.15,RV-order-c,c,1,4,12,0,17
6,300,-1478.15,RV-disorder-c,c,2,2,8,3,15
6,300,-1478.15,RV-order-g,g,0,3,1,6,10
6,300,-1478.15,RV-disorder-g,g,0,5,6,16,27
6,300,-1478.15,RV-O,O,56,10,66
6,300,-1478.15,RV-D,D,21,70,91
7,350,-1468.49,RV-order-a,a,22,3,2,2,29
7,350,-1468.49,RV-disorder-a,a,13,1,3,3,20
7,350,-1468.49,RV-order-t,t,3,10,0,2,15
7,350,-1468.49,RV-disorder-t,t,3,27,4,3,37
7,350,-1468.49,RV-order-c,c,1,4,12,0,17
7,350,-1468.49,RV-disorder-c,c,2,2,8,3,15
7,350,-1468.49,RV-order-g,g,0,3,1,6,10
7,350,-1468.49,RV-disorder-g,g,0,5,6,16,27
7,350,-1468.49,RV-O,O,56,10,66
7,350,-1468.49,RV-D,D,21,70,91
8,400,-1457.43,RV-order-a,a,22,3,2,2,29
8,400,-1457.43,RV-disorder-a,a,13,1,3,3,20
8,400,-1457.43,RV-order-t,t,3,10,0,2,15
8,400,-1457.43,RV-disorder-t,t,3,27,4,3,37
8,400,-1457.43,RV-order-c,c,1,4,12,0,17
8,400,-1457.43,RV-disorder-c,c,2,2,8,3,15
8,400,-1457.43,RV-order-g,g,0,3,1,6,10
8,400,-1457.43,RV-disorder-g,g,0,5,6,16,27
8,400,-1457.43,RV-O,O,56,10,66
8,400,-1457.43,RV-D,D,21,70,91
9,450,-1452.19,RV-order-a,a,22,3,2,2,29
9,450,-1452.19,RV-disorder-a,a,13,1,3,3,20
9,450,-1452.19,RV-order-t,t,3,10,0,2,15
9,450,-1452.19,RV-disorder-t,t,3,27,4,3,37
9,450,-1452.19,RV-order-c,c,1,4,12,0,17
9,450,-1452.19,RV-disorder-c,c,2,2,8,3,15
9,450,-1452.19,RV-order-g,g,0,3,1,6,10
9,450,-1452.19,RV-disorder-g,g,0,5,6,16,27
9,450,-1452.19,RV-O,O,56,10,66
9,450,-1452.19,RV-D,D,21,70,91
10,500,-1448.31,RV-order-a,a,22,3,2,2,29
10,500,-1448.31,RV-disorder-a,a,13,1,3,3,20
10,500,-1448.31,RV-order-t,t,3,10,0,2,15
10,500,-1448.31,RV-disorder-t,t,3,27,4,3,37
10,500,-1448.31,RV-order-c,c,1,4,12,0,17
10,500,-1448.31,RV-disorder-c,c,2,2,8,3,15
10,500,-1448.31,RV-order-g,g,0,3,1,6,10
10,500,-1448.31,RV-disorder-g,g,0,5,6,16,27
10,500,-1448.31,RV-O,O,56,10,66
10,500,-1448.31,RV-D,D,21,70,91
11,550,-1418.9,RV-order-a,a,14,2,2,3,21
11,550,-1418.9,RV-disorder-a,a,17,2,3,2,24
11,550,-1418.9,RV-order-t,t,4,32,4,4,44
11,550,-1418.9,RV-disorder-t,t,2,2,0,1,5
11,550,-1418.9,RV-order-c,c,2,4,6,3,15
11,550,-1418.9,RV-disorder-c,c,1,2,7,0,10
11,550,-1418.9,RV-order-g,g,0,5,6,17,28
11,550,-1418.9,RV-disorder-g,g,0,3,1,4,8
11,550,-1418.9,RV-O,O,93,24,117
11,550,-1418.9,RV-D,D,10,34,44
12,600,-1414.98,RV-order-a,a,14,2,2,3,21
12,600,-1414.98,RV-disorder-a,a,17,2,3,2,24
12,600,-1414.98,RV-order-t,t,4,32,4,4,44
12,600,-1414.98,RV-disorder-t,t,2,2,0,1,5
12,600,-1414.98,RV-order-c,c,2,4,6,3,15
12,600,-1414.98,RV-disorder-c,c,1,2,7,0,10
12,600,-1414.98,RV-order-g,g,0,5,6,17,28
12,600,-1414.98,RV-disorder-g,g,0,3,1,4,8
12,600,-1414.98,RV-O,O,93,24,117
12,600,-1414.98,RV-D,D,10,34,44
13,650,-1411.22,RV-order-a,a,14,2,2,3,21
13,650,-1411.22,RV-disorder-a,a,17,2,3,2,24
13,650,-1411.22,RV-order-t,t,4,32,4,4,44
13,650,-1411.22,RV-disorder-t,t,2,2,0,1,5
13,650,-1411.22,RV-order-c,c,2,4,6,3,15
13,650,-1411.22,RV-disorder-c,c,1,2,7,0,10
13,650,-1411.22,RV-order-g,g,0,5,6,17,28
13,650,-1411.22,RV-disorder-g,g,0,3,1,4,8
13,650,-1411.22,RV-O,O,93,24,117
13,650,-1411.22,RV-D,D,10,34,44
14,700,-1408.53,RV-order-a,a,14,2,2,3,21
14,700,-1408.53,RV-disorder-a,a,17,2,3,2,24
14,700,-1408.53,RV-order-t,t,4,32,4,4,44
14,700,-1408.53,RV-disorder-t,t,2,2,0,1,5
14,700,-1408.53,RV-order-c,c,2,4,6,3,15
14,700,-1408.53,RV-disorder-c,c,1,2,7,0,10
14,700,-1408.53,RV-order-g,g,0,5,6,17,28
14,700,-1408.53,RV-disorder-g,g,0,3,1,4,8
14,700,-1408.53,RV-O,O,93,24,117
14,700,-1408.53,RV-D,D,10,34,44
15,750,-1406.87,RV-order-a,a,14,2,2,3,21
15,750,-1406.87,RV-disorder-a,a,17,2,3,2,24
15,750,-1406.87,RV-order-t,t,4,32,4,4,44
15,750,-1406.87,RV-disorder-t,t,2,2,0,1,5
15,750,-1406.87,RV-order-c,c,2,4,6,3,15
15,750,-1406.87,RV-disorder-c,c,1,2,7,0,10
15,750,-1406.87,RV-order-g,g,0,5,6,17,28
15,750,-1406.87,RV-disorder-g,g,0,3,1,4,8
15,750,-1406.87,RV-O,O,93,24,117
15,750,-1406.87,RV-D,D,10,34,44
16,800,-1337.58,RV-order-a,a,19,7,1,2,29
16,800,-1337.58,RV-disorder-a,a,5,1,1,0,7
16,800,-1337.58,RV-order-t,t,1,16,5,7,29
16,800,-1337.58,RV-disorder-t,t,1,11,3,2,17
16,800,-1337.58,RV-order-c,c,4,5,27,6,42
16,800,-1337.58,RV-disorder-c,c,1,0,4,1,6
16,800,-1337.58,RV-order-g,g,2,2,1,5,10
16,800,-1337.58,RV-disorder-g,g,3,1,0,6,10
16,800,-1337.58,RV-O,O,75,24,99
16,800,-1337.58,RV-D,D,10,36,46
17,850,-1334.03,RV-order-a,a,19,7,1,2,29
17,850,-1334.03,RV-disorder-a,a,5,1,1,0,7
17,850,-1334.03,RV-order-t,t,1,16,5,7,29
17,850,-1334.03,RV-disorder-t,t,1,11,3,2,17
17,850,-1334.03,RV-order-c,c,4,5,27,6,42
17,850,-1334.03,RV-disorder-c,c,1,0,4,1,6
17,850,-1334.03,RV-order-g,g,2,2,1,5,10
17,850,-1334.03,RV-disorder-g,g,3,1,0,6,10
17,850,-1334.03,RV-O,O,75,24,99
17,850,-1334.03,RV-D,D,10,36,46
18,900,-1332.24,RV-order-a,a,19,7,1,2,29
18,900,-1332.24,RV-disorder-a,a,5,1,1,0,7
18,900,-1332.24,RV-order-t,t,1,16,5,7,29
18,900,-1332.24,RV-disorder-t,t,1,11,3,2,17
18,900,-1332.24,RV-order-c,c,4,5,27,6,42
18,900,-1332.24,RV-disorder-c,c,1,0,4,1,6
18,900,-1332.24,RV-order-g,g,2,2,1,5,10
18,900,-1332.24,RV-disorder-g,g,3,1,0,6,10
18,900,-1332.24,RV-O,O,75,24,99
18,900,-1332.24,RV-D,D,10,36,46
19,950,-1331.49,RV-order-a,a,19,7,1,2,29
19,950,-1331.49,RV-disorder-a,a,5,1,1,0,7
19,950,-1331.49,RV-order-t,t,1,16,5,7,29
19,950,-1331.49,RV-disorder-t,t,1,11,3,2,17
19,950,-1331.49,RV-order-c,c,4,5,27,6,42
19,950,-1331.49,RV-disorder-c,c,1,0,4,1,6
19,950,-1331.49,RV-order-g,g,2,2,1,5,10
19,950,-1331.49,RV-disorder-g,g,3,1,0,6,10
19,950,-1331.49,RV-O,O,75,24,99
19,950,-1331.49,RV-D,D,10,36,46
20,1000,-1332,RV-order-a,a,19,7,1,2,29
20,1000,-1332,RV-disorder-a,a,5,1,1,0,7
20,1000,-1332,RV-order-t,t,1,16,5,7,29
20,1000,-1332,RV-disorder-t,t,1,11,3,2,17
20,1000,-1332,RV-order-c,c,4,5,27,6,42
20,1000,-1332,RV-disorder-c,c,1,0,4,1,6
20,1000,-1332,RV-order-g,g,2,2,1,5,10
20,1000,-1332,RV-disorder-g,g,3,1,0,6,10
20,1000,-1332,RV-O,O,75,24,99
20,1000,-1332,RV-D,D,10,36,46
21,1050,-1374.7,RV-order-a,a,9,4,1,1,15
21,1050,-1374.7,RV-disorder-a,a,12,4,1,1,18
21,1050,-1374.7,RV-order-t,t,2,22,4,3,31
21,1050,-1374.7,RV-disorder-t,t,0,20,4,6,30
21,1050,-1374.7,RV-order-c,c,1,3,10,3,17
21,1050,-1374.7,RV-disorder-c,c,4,2,17,4,27
21,1050,-1374.7,RV-order-g,g,4,2,1,14,21
21,1050,-1374.7,RV-disorder-g,g,1,1,0,2,4
21,1050,-1374.7,RV-O,O,69,12,81
21,1050,-1374.7,RV-D,D,16,54,70
22,1100,-1373.84,RV-order-a,a,9,4,1,1,15
22,1100,-1373.84,RV-disorder-a,a,12,4,1,1,18
22,1100,-1373.84,RV-order-t,t,2,22,4,3,31
22,1100,-1373.84,RV-disorder-t,t,0,20,4,6,30
22,1100,-1373.84,RV-order-c,c,1,3,10,3,17
22,1100,-1373.84,RV-disorder-c,c,4,2,17,4,27
22,1100,-1373.84,RV-order-g,g,4,2,1,14,21
22,1100,-1373.84,RV-disorder-g,g,1,1,0,2,4
22,1100,-1373.84,RV-O,O,69,12,81
22,1100,-1373.84,RV-D,D,16,54,70
23,1150,-1370.55,RV-order-a,a,9,4,1,1,15
23,1150,-1370.55,RV-disorder-a,a,12,4,1,1,18
23,1150,-1370.55,RV-order-t,t,2,22,4,3,31
23,1150,-1370.55,RV-disorder-t,t,0,20,4,6,30
23,1150,-1370.55,RV-order-c,c,1,3,10,3,17
23,1150,-1370.55,RV-disorder-c,c,4,2,17,4,27
23,1150,-1370.55,RV-order-g,g,4,2,1,14,21
23,1150,-1370.55,RV-disorder-g,g,1,1,0,2,4
23,1150,-1370.55,RV-O,O,69,12,81
23,1150,-1370.55,RV-D,D,16,54,70
24,1200,-1368.43,RV-order-a,a,9,4,1,1,15
24,1200,-1368.43,RV-disorder-a,a,12,4,1,1,18
24,1200,-1368.43,RV-order-t,t,2,22,4,3,31
24,1200,-1368.43,RV-disorder-t,t,0,20,4,6,30
24,1200,-1368.43,RV-order-c,c,1,3,10,3,17
24,1200,-1368.43,RV-disorder-c,c,4,2,17,4,27
24,1200,-1368.43,RV-order-g,g,4,2,1,14,21
24,1200,-1368.43,RV-disorder-g,g,1,1,0,2,4
24,1200,-1368.43,RV-O,O,69,12,81
24,1200,-1368.43,RV-D,D,16,54,70
25,1250,-1367.72,RV-order-a,a,9,4,1,1,15
25,1250,-1367.72,RV-disorder-a,a,12,4,1,1,18
25,1250,-1367.72,RV-order-t,t,2,22,4,3,31
25,1250,-1367.72,RV-disorder-t,t,0,20,4,6,30
25,1250,-1367.72,RV-order-c,c,1,3,10,3,17
25,1250,-1367.72,RV-disorder-c,c,4,2,17,4,27
25,1250,-1367.72,RV-order-g,g,4,2,1,14,21
25,1250,-1367.72,RV-disorder-g,g,1,1,0,2,4
25,1250,-1367.72,RV-O,O,69,12,81
25,1250,-1367.72,RV-D,D,16,54,70
26,1300,-1283.71,RV-order-a,a,10,3,2,3,18
26,1300,-1283.71,RV-disorder-a,a,15,1,3,2,21
26,1300,-1283.71,RV-order-t,t,3,15,3,3,24
26,1300,-1283.71,RV-disorder-t,t,4,29,3,3,39
26,1300,-1283.71,RV-order-c,c,1,4,12,0,17
26,1300,-1283.71,RV-disorder-c,c,1,0,2,0,3
26,1300,-1283.71,RV-order-g,g,0,3,1,5,9
26,1300,-1283.71,RV-disorder-g,g,1,5,6,21,33
26,1300,-1283.71,RV-O,O,47,12,59
26,1300,-1283.71,RV-D,D,16,51,67
27,1350,-1283.78,RV-order-a,a,10,3,2,3,18
27,1350,-1283.78,RV-disorder-a,a,15,1,3,2,21
27,1350,-1283.78,RV-order-t,t,3,15,3,3,24
27,1350,-1283.78,RV-disorder-t,t,4,29,3,3,39
27,1350,-1283.78,RV-order-c,c,1,4,12,0,17
27,1350,-1283.78,RV-disorder-c,c,1,0,2,0,3
27,1350,-1283.78,RV-order-g,g,0,3,1,5,9
27,1350,-1283.78,RV-disorder-g,g,1,5,6,21,33
27,1350,-1283.78,RV-O,O,47,12,59
27,1350,-1283.78,RV-D,D,16,51,67
28,1400,-1280.53,RV-order-a,a,10,3,2,3,18
28,1400,-1280.53,RV-disorder-a,a,15,1,3,2,21
28,1400,-1280.53,RV-order-t,t,3,15,3,3,24
28,1400,-1280.53,RV-disorder-t,t,4,29,3,3,39
28,1400,-1280.53,RV-order-c,c,1,4,12,0,17
28,1400,-1280.53,RV-disorder-c,c,1,0,2,0,3
28,1400,-1280.53,RV-order-g,g,0,3,1,5,9
28,1400,-1280.53,RV-disorder-g,g,1,5,6,21,33
28,1400,-1280.53,RV-O,O,47,12,59
28,1400,-1280.53,RV-D,D,16,51,67
29,1450,-1279.35,RV-order-a,a,10,3,2,3,18
29,1450,-1279.35,RV-disorder-a,a,15,1,3,2,21
29,1450,-1279.35,RV-order-t,t,3,15,3,3,24
29,1450,-1279.35,RV-disorder-t,t,4,29,3,3,39
29,1450,-1279.35,RV-order-c,c,1,4,12,0,17
29,1450,-1279.35,RV-disorder-c,c,1,0,2,0,3
29,1450,-1279.35,RV-order-g,g,0,3,1,5,9
29,1450,-1279.35,RV-disorder-g,g,1,5,6,21,33
29,1450,-1279.35,RV-O,O,47,12,59
29,1450,-1279.35,RV-D,D,16,51,67
30,1500,-1278.01,RV-order-a,a,10,3,2,3,18
30,1500,-1278.01,RV-disorder-a,a,15,1,3,2,21
30,1500,-1278.01,RV-order-t,t,3,15,3,3,24
30,1500,-1278.01,RV-disorder-t,t,4,29,3,3,39
30,1500,-1278.01,RV-order-c,c,1,4,12,0,17
30,1500,-1278.01,RV-disorder-c,c,1,0,2,0,3
30,1500,-1278.01,RV-order-g,g,0,3,1,5,9
30,1500,-1278.01,RV-disorder-g,g,1,5,6,21,33
30,1500,-1278.01,RV-O,O,47,12,59
30,1500,-1278.01,RV-D,D,16,51,67
31,1550,-1338.12,RV-order-a,a,10,4,1,3,18
31,1550,-1338.12,RV-disorder-a,a,11,0,4,2,17
31,1550,-1338.12,RV-order-t,t,4,38,6,5,53
31,1550,-1338.12,RV-disorder-t,t,3,9,0,1,13
31,1550,-1338.12,RV-order-c,c,2,3,9,0,14
31,1550,-1338.12,RV-disorder-c,c,0,1,3,0,4
31,1550,-1338.12,RV-order-g,g,1,5,4,15,25
31,1550,-1338.12,RV-disorder-g,g,0,3,3,11,17
31,1550,-1338.12,RV-O,O,79,20,99
31,1550,-1338.12,RV-D,D,10,36,46
32,1600,-1338.04,RV-order-a,a,10,4,1,3,18
32,1600,-1338.04,RV-disorder-a,a,11,0,4,2,17
32,1600,-1338.04,RV-order-t,t,4,38,6,5,53
32,1600,-1338.04,RV-disorder-t,t,3,9,0,1,13
32,1600,-1338.04,RV-order-c,c,2,3,9,0,14
32,1600,-1338.04,RV-disorder-c,c,0,1,3,0,4
32,1600,-1338.04,RV-order-g,g,1,5,4,15,25
32,1600,-1338.04,RV-disorder-g,g,0,3,3,11,17
32,1600,-1338.04,RV-O,O,79,20,99
32,1600,-1338.04,RV-D,D,10,36,46
33,1650,-1337.13,RV-order-a,a,10,4,1,3,18
33,1650,-1337.13,RV-disorder-a,a,11,0,4,2,17
33,1650,-1337.13,RV-order-t,t,4,38,6,5,53
33,1650,-1337.13,RV-disorder-t,t,3,9,0,1,13
33,1650,-1337.13,RV-order-c,c,2,3,9,0,14
33,1650,-1337.13,RV-disorder-c,c,0,1,3,0,4
33,1650,-1337.13,RV-order-g,g,1,5,4,15,25
33,1650,-1337.13,RV-disorder-g,g,0,3,3,11,17
33,1650,-1337.13,RV-O,O,79,20,99
33,1650,-1337.13,RV-D,D,10,36,46
34,1700,-1337.94,RV-order-a,a,10,4,1,3,18
34,1700,-1337.94,RV-disorder-a,a,11,0,4,2,17
34,1700,-1337.94,RV-order-t,t,4,38,6,5,53
34,1700,-1337.94,RV-disorder-t,t,3,9,0,1,13
34,1700,-1337.94,RV-order-c,c,2,3,9,0,14
34,1700,-1337.94,RV-disorder-c,c,0,1,3,0,4
34,1700,-1337.94,RV-order-g,g,1,5,4,15,25
34,1700,-1337.94,RV-disorder-g,g,0,3,3,11,17
34,1700,-1337.94,RV-O,O,79,20,99
34,1700,-1337.94,RV-D,D,10,36,46
35,1750,-1337.97,RV-order-a,a,10,4,1,3,18
35,1750,-1337.97,RV-disorder-a,a,11,0,4,2,17
35,1750,-1337.97,RV-order-t,t,4,38,6,5,53
35,1750,-1337.97,RV-disorder-t,t,3,9,0,1,13
35,1750,-1337.97,RV-order-c,c,2,3,9,0,14
35,1750,-1337.97,RV-disorder-c,c,0,1,3,0,4
35,1750,-1337.97,RV-order-g,g,1,5,4,15,25
35,1750,-1337.97,RV-disorder-g,g,0,3,3,11,17
35,1750,-1337.97,RV-O,O,79,20,99
35,1750,-1337.97,RV-D,D,10,36,46
36,1800,-1342.83,RV-order-a,a,15,5,1,2,23
36,1800,-1342.83,RV-disorder-a,a,12,2,0,1,15
36,1800,-1342.83,RV-order-t,t,3,20,2,4,29
36,1800,-1342.83,RV-disorder-t,t,0,8,3,1,12
36,1800,-1342.83,RV-order-c,c,0,7,23,3,33
36,1800,-1342.83,RV-disorder-c,c,5,1,12,4,22
36,1800,-1342.83,RV-order-g,g,3,6,2,11,22
36,1800,-1342.83,RV-disorder-g,g,0,0,1,1,2
36,1800,-1342.83,RV-O,O,80,20,100
36,1800,-1342.83,RV-D,D,10,41,51
37,1850,-1339.41,RV-order-a,a,15,5,1,2,23
37,1850,-1339.41,RV-disorder-a,a,12,2,0,1,15
37,1850,-1339.41,RV-order-t,t,3,20,2,4,29
37,1850,-1339.41,RV-disorder-t,t,0,8,3,1,12
37,1850,-1339.41,RV-order-c,c,0,7,23,3,33
37,1850,-1339.41,RV-disorder-c,c,5,1,12,4,22
37,1850,-1339.41,RV-order-g,g,3,6,2,11,22
37,1850,-1339.41,RV-disorder-g,g,0,0,1,1,2
37,1850,-1339.41,RV-O,O,80,20,100
37,1850,-1339.41,RV-D,D,10,41,51
38,1900,-1339.59,RV-order-a,a,15,5,1,2,23
38,1900,-1339.59,RV-disorder-a,a,12,2,0,1,15
38,1900,-1339.59,RV-order-t,t,3,20,2,4,29
38,1900,-1339.59,RV-disorder-t,t,0,8,3,1,12
38,1900,-1339.59,RV-order-c,c,0,7,23,3,33
38,1900,-1339.59,RV-disorder-c,c,5,1,12,4,22
38,1900,-1339.59,RV-order-g,g,3,6,2,11,22
38,1900,-1339.59,RV-disorder-g,g,0,0,1,1,2
38,1900,-1339.59,RV-O,O,80,20,100
38,1900,-1339.59,RV-D,D,10,41,51
39,1950,-1338.1,RV-order-a,a,15,5,1,2,23
39,1950,-1338.1,RV-disorder-a,a,12,2,0,1,15
39,1950,-1338.1,RV-order-t,t,3,20,2,4,29
39,1950,-1338.1,RV-disorder-t,t,0,8,3,1,12
39,1950,-1338.1,RV-order-c,c,0,7,23,3,33
39,1950,-1338.1,RV-disorder-c,c,5,1,12,4,22
39,1950,-1338.1,RV-order-g,g,3,6,2,11,22
39,1950,-1338.1,RV-disorder-g,g,0,0,1,1,2
39,1950,-1338.1,RV-O,O,80,20,100
39,1950,-1338.1,RV-D,D,10,41,51
40,2000,-1337.3,RV-order-a,a,15,5,1,2,23
40,2000,-1337.3,RV-disorder-a,a,12,2,0,1,15
40,2000,-1337.3,RV-order-t,t,3,20,2,4,29
40,2000,-1337.3,RV-disorder-t,t,0,8,3,1,12
40,2000,-1337.3,RV-order-c,c,0,7,23,3,33
40,2000,-1337.3,RV-disorder-c,c,5,1,12,4,22
40,2000,-1337.3,RV-order-g,g,3,6,2,11,22
40,2000,-1337.3,RV-disorder-g,g,0,0,1,1,2
40,2000,-1337.3,RV-O,O,80,20,100
40,2000,-1337.3,RV-D,D,10,41,51
