I,GEN,LogL,RateVector,State,a,c,g,t,Total
0,0,-1167.73,RV-a,a,33,6,3,6,48
0,0,-1167.73,RV-c,c,0,14,3,3,20
0,0,-1167.73,RV-g,g,1,1,4,1,7
0,0,-1167.73,RV-t,t,7,9,7,64,87
1,100,-1101.48,RV-a,a,33,6,3,6,48
1,100,-1101.48,RV-c,c,0,14,3,3,20
1,100,-1101.48,RV-g,g,1,1,4,1,7
1,100,-1101.48,RV-t,t,7,9,7,64,87
2,200,-1068.26,RV-a,a,33,6,3,6,48
2,200,-1068.26,RV-c,c,0,14,3,3,20
2,200,-1068.26,RV-g,g,1,1,4,1,7
2,200,-1068.26,RV-t,t,7,9,7,64,87
3,300,-1072.62,RV-a,a,36,5,4,4,49
3,300,-1072.62,RV-c,c,0,15,2,1,18
3,300,-1072.62,RV-g,g,1,2,6,0,9
3,300,-1072.62,RV-t,t,9,10,8,68,95
4,400,-1058.7,RV-a,a,36,5,4,4,49
4,400,-1058.7,RV-c,c,0,15,2,1,18
4,400,-1058.7,RV-g,g,1,2,6,0,9
4,400,-1058.7,RV-t,t,9,10,8,68,95
5,500,-971.296,RV-a,a,15,5,2,2,24
5,500,-971.296,RV-c,c,0,9,3,1,13
5,500,-971.296,RV-g,g,2,1,4,0,7
5,500,-971.296,RV-t,t,10,11,9,74,104
6,600,-956.159,RV-a,a,15,5,2,2,24
6,600,-956.159,RV-c,c,0,9,3,1,13
6,600,-956.159,RV-g,g,2,1,4,0,7
6,600,-956.159,RV-t,t,10,11,9,74,104
7,700,-1040.93,RV-a,a,28,5,3,2,38
7,700,-1040.93,RV-c,c,0,15,2,1,18
7,700,-1040.93,RV-g,g,2,1,6,0,9
7,700,-1040.93,RV-t,t,10,11,9,80,110
8,800,-1033.44,RV-a,a,28,5,3,2,38
8,800,-1033.44,RV-c,c,0,15,2,1,18
8,800,-1033.44,RV-g,g,2,1,6,0,9
8,800,-1033.44,RV-t,t,10,11,9,80,110
9,900,-963.332,RV-a,a,26,5,3,2,36
9,900,-963.332,RV-c,c,0,11,1,1,13
9,900,-963.332,RV-g,g,1,1,5,0,7
9,900,-963.332,RV-t,t,11,11,10,69,101
10,1000,-959.931,RV-a,a,26,5,3,2,36
10,1000,-959.931,RV-c,c,0,11,1,1,13
10,1000,-959.931,RV-g,g,1,1,5,0,7
10,1000,-959.931,RV-t,t,11,11,10,69,101
