I,GEN,LogL,RateVector,State,a,t,c,g,Total
0,0,-1642.84,RV-order-a,a,12,5,1,2,20
0,0,-1642.84,RV-disorder-a,a,9,2,1,2,14
0,0,-1642.84,RV-order-t,t,1,25,4,3,33
0,0,-1642.84,RV-disorder-t,t,1,11,2,2,16
0,0,-1642.84,RV-order-c,c,2,6,19,3,30
0,0,-1642.84,RV-disorder-c,c,2,2,10,1,15
0,0,-1642.84,RV-order-g,g,2,5,4,12,23
0,0,-1642.84,RV-disorder-g,g,3,1,0,6,10
0,0,-1642.84,RV-O,O,80,19,99
0,0,-1642.84,RV-D,D,18,34,52
1,50,-1457.92,RV-order-a,a,18,5,1,3,27
1,50,-1457.92,RV-disorder-a,a,6,2,1,1,10
1,50,-1457.92,RV-order-t,t,2,18,2,2,24
1,50,-1457.92,RV-disorder-t,t,0,14,4,3,21
1,50,-1457.92,RV-order-c,c,1,6,11,1,19
1,50,-1457.92,RV-disorder-c,c,3,2,13,3,21
1,50,-1457.92,RV-order-g,g,3,5,1,11,20
1,50,-1457.92,RV-disorder-g,g,2,1,3,12,18
1,50,-1457.92,RV-O,O,62,15,77
1,50,-1457.92,RV-D,D,11,44,55
2,100,-1410.41,RV-order-a,a,18,5,1,3,27
2,100,-1410.41,RV-disorder-a,a,6,2,1,1,10
2,100,-1410.41,RV-order-t,t,2,18,2,2,24
2,100,-1410.41,RV-disorder-t,t,0,14,4,3,21
2,100,-1410.41,RV-order-c,c,1,6,11,1,19
2,100,-1410.41,RV-disorder-c,c,3,2,13,3,21
2,100,-1410.41,RV-order-g,g,3,5,1,11,20
2,100,-1410.41,RV-disorder-g,g,2,1,3,12,18
2,100,-1410.41,RV-O,O,62,15,77
2,100,-1410.41,RV-D,D,11,44,55
3,150,-1381.89,RV-order-a,a,18,5,1,3,27
3,150,-1381.89,RV-disorder-a,a,6,2,1,1,10
3,150,-1381.89,RV-order-t,t,2,18,2,2,24
3,150,-1381.89,RV-disorder-t,t,0,14,4,3,21
3,150,-1381.89,RV-order-c,c,1,6,11,1,19
3,150,-1381.89,RV-disorder-c,c,3,2,13,3,21
3,150,-1381.89,RV-order-g,g,3,5,1,11,20
3,150,-1381.89,RV-disorder-g,g,2,1,3,12,18
3,150,-1381.89,RV-O,O,62,15,77
3,150,-1381.89,RV-D,D,11,44,55
4,200,-1373.25,RV-order-a,a,18,5,1,3,27
4,200,-1373.25,RV-disorder-a,a,6,2,1,1,10
4,200,-1373.25,RV-order-t,t,2,18,2,2,24
4,200,-1373.25,RV-disorder-t,t,0,14,4,3,21
4,200,-1373.25,RV-order-c,c,1,6,11,1,19
4,200,-1373.25,RV-disorder-c,c,3,2,13,3,21
4,200,-1373.25,RV-order-g,g,3,5,1,11,20
4,200,-1373.25,RV-disorder-g,g,2,1,3,12,18
4,200,-1373.25,RV-O,O,62,15,77
4,200,-1373.25,RV-D,D,11,44,55
5,250,-1387.26,RV-order-a,a,18,2,2,2,24
5,250,-1387.26,RV-disorder-a,a,10,0,2,2,14
5,250,-1387.26,RV-order-t,t,6,33,2,5,46
5,250,-1387.26,RV-disorder-t,t,1,15,1,2,19
5,250,-1387.26,RV-order-c,c,1,5,19,1,26
5,250,-1387.26,RV-disorder-c,c,0,2,10,2,14
5,250,-1387.26,RV-order-g,g,0,0,0,2,2
5,250,-1387.26,RV-disorder-g,g,1,3,4,8,16
5,250,-1387.26,RV-O,O,72,15,87
5,250,-1387.26,RV-D,D,11,54,65
6,300,-1378.76,RV-order-a,a,18,2,2,2,24
6,300,-1378.76,RV-disorder-a,a,10,0,2,2,14
6,300,-1378.76,RV-order-t,t,6,33,2,5,46
6,300,-1378.76,RV-disorder-t,t,1,15,1,2,19
6,300,-1378.76,RV-order-c,c,1,5,19,1,26
6,300,-1378.76,RV-disorder-c,c,0,2,10,2,14
6,300,-1378.76,RV-order-g,g,0,0,0,2,2
6,300,-1378.76,RV-disorder-g,g,1,3,4,8,16
6,300,-1378.76,RV-O,O,72,15,87
6,300,-1378.76,RV-D,D,11,54,65
7,350,-1373.69,RV-order-a,a,18,2,2,2,24
7,350,-1373.69,RV-disorder-a,a,10,0,2,2,14
7,350,-1373.69,RV-order-t,t,6,33,2,5,46
7,350,-1373.69,RV-disorder-t,t,1,15,1,2,19
7,350,-1373.69,RV-order-c,c,1,5,19,1,26
7,350,-1373.69,RV-disorder-c,c,0,2,10,2,14
7,350,-1373.69,RV-order-g,g,0,0,0,2,2
7,350,-1373.69,RV-disorder-g,g,1,3,4,8,16
7,350,-1373.69,RV-O,O,72,15,87
7,350,-1373.69,RV-D,D,11,54,65
8,400,-1363.34,RV-order-a,a,18,2,2,2,24
8,400,-1363.34,RV-disorder-a,a,10,0,2,2,14
8,400,-1363.34,RV-order-t,t,6,33,2,5,46
8,400,-1363.34,RV-disorder-t,t,1,15,1,2,19
8,400,-1363.34,RV-order-c,c,1,5,19,1,26
8,400,-1363.34,RV-disorder-c,c,0,2,10,2,14
8,400,-1363.34,RV-order-g,g,0,0,0,2,2
8,400,-1363.34,RV-disorder-g,g,1,3,4,8,16
8,400,-1363.34,RV-O,O,72,15,87
8,400,-1363.34,RV-D,D,11,54,65
9,450,-1360.46,RV-order-a,a,18,2,2,2,24
9,450,-1360.46,RV-disorder-a,a,10,0,2,2,14
9,450,-1360.46,RV-order-t,t,6,33,2,5,46
9,450,-1360.46,RV-disorder-t,t,1,15,1,2,19
9,450,-1360.46,RV-order-c,c,1,5,19,1,26
9,450,-1360.46,RV-disorder-c,c,0,2,10,2,14
9,450,-1360.46,RV-order-g,g,0,0,0,2,2
9,450,-1360.46,RV-disorder-g,g,1,3,4,8,16
9,450,-1360.46,RV-O,O,72,15,87
9,450,-1360.46,RV-D,D,11,54,65
10,500,-1358.84,RV-order-a,a,18,2,2,2,24
10,500,-1358.84,RV-disorder-a,a,10,0,2,2,14
10,500,-1358.84,RV-order-t,t,6,33,2,5,46
10,500,-1358.84,RV-disorder-t,t,1,15,1,2,19
10,500,-1358.84,RV-order-c,c,1,5,19,1,26
10,500,-1358.84,RV-disorder-c,c,0,2,10,2,14
10,500,-1358.84,RV-order-g,g,0,0,0,2,2
10,500,-1358.84,RV-disorder-g,g,1,3,4,8,16
10,500,-1358.84,RV-O,O,72,15,87
10,500,-1358.84,RV-D,D,11,54,65
11,550,-1350.33,RV-order-a,a,6,2,1,1,10
11,550,-1350.33,RV-disorder-a,a,19,0,3,3,25
11,550,-1350.33,RV-order-t,t,4,26,3,4,37
11,550,-1350.33,RV-disorder-t,t,3,12,0,3,18
11,550,-1350.33,RV-order-c,c,1,4,23,1,29
11,550,-1350.33,RV-disorder-c,c,0,3,9,2,14
11,550,-1350.33,RV-order-g,g,0,0,1,8,9
11,550,-1350.33,RV-disorder-g,g,1,3,3,13,20
11,550,-1350.33,RV-O,O,66,15,81
11,550,-1350.33,RV-D,D,11,57,68
12,600,-1346.35,RV-order-a,a,6,2,1,1,10
12,600,-1346.35,RV-disorder-a,a,19,0,3,3,25
12,600,-1346.35,RV-order-t,t,4,26,3,4,37
12,600,-1346.35,RV-disorder-t,t,3,12,0,3,18
12,600,-1346.35,RV-order-c,c,1,4,23,1,29
12,600,-1346.35,RV-disorder-c,c,0,3,9,2,14
12,600,-1346.35,RV-order-g,g,0,0,1,8,9
12,600,-1346.35,RV-disorder-g,g,1,3,3,13,20
12,600,-1346.35,RV-O,O,66,15,81
12,600,-1346.35,RV-D,D,11,57,68
13,650,-1342.5,RV-order-a,a,6,2,1,1,10
13,650,-1342.5,RV-disorder-a,a,19,0,3,3,25
13,650,-1342.5,RV-order-t,t,4,26,3,4,37
13,650,-1342.5,RV-disorder-t,t,3,12,0,3,18
13,650,-1342.5,RV-order-c,c,1,4,23,1,29
13,650,-1342.5,RV-disorder-c,c,0,3,9,2,14
13,650,-1342.5,RV-order-g,g,0,0,1,8,9
13,650,-1342.5,RV-disorder-g,g,1,3,3,13,20
13,650,-1342.5,RV-O,O,66,15,81
13,650,-1342.5,RV-D,D,11,57,68
14,700,-1340.27,RV-order-a,a,6,2,1,1,10
14,700,-1340.27,RV-disorder-a,a,19,0,3,3,25
14,700,-1340.27,RV-order-t,t,4,26,3,4,37
14,700,-1340.27,RV-disorder-t,t,3,12,0,3,18
14,700,-1340.27,RV-order-c,c,1,4,23,1,29
14,700,-1340.27,RV-disorder-c,c,0,3,9,2,14
14,700,-1340.27,RV-order-g,g,0,0,1,8,9
14,700,-1340.27,RV-disorder-g,g,1,3,3,13,20
14,700,-1340.27,RV-O,O,66,15,81
14,700,-1340.27,RV-D,D,11,57,68
15,750,-1340.65,RV-order-a,a,6,2,1,1,10
15,750,-1340.65,RV-disorder-a,a,19,0,3,3,25
15,750,-1340.65,RV-order-t,t,4,26,3,4,37
15,750,-1340.65,RV-disorder-t,t,3,12,0,3,18
15,750,-1340.65,RV-order-c,c,1,4,23,1,29
15,750,-1340.65,RV-disorder-c,c,0,3,9,2,14
15,750,-1340.65,RV-order-g,g,0,0,1,8,9
15,750,-1340.65,RV-disorder-g,g,1,3,3,13,20
15,750,-1340.65,RV-O,O,66,15,81
15,750,-1340.65,RV-D,D,11,57,68
16,800,-1304.98,RV-order-a,a,11,1,1,2,15
16,800,-1304.98,RV-disorder-a,a,15,0,4,2,21
16,800,-1304.98,RV-order-t,t,5,31,3,4,43
16,800,-1304.98,RV-disorder-t,t,4,14,1,3,22
16,800,-1304.98,RV-order-c,c,1,5,17,2,25
16,800,-1304.98,RV-disorder-c,c,0,3,6,1,10
16,800,-1304.98,RV-order-g,g,0,1,0,6,7
16,800,-1304.98,RV-disorder-g,g,0,1,2,6,9
16,800,-1304.98,RV-O,O,73,15,88
16,800,-1304.98,RV-D,D,11,50,61
17,850,-1303.52,RV-order-a,a,11,1,1,2,15
17,850,-1303.52,RV-disorder-a,a,15,0,4,2,21
17,850,-1303.52,RV-order-t,t,5,31,3,4,43
17,850,-1303.52,RV-disorder-t,t,4,14,1,3,22
17,850,-1303.52,RV-order-c,c,1,5,17,2,25
17,850,-1303.52,RV-disorder-c,c,0,3,6,1,10
17,850,-1303.52,RV-order-g,g,0,1,0,6,7
17,850,-1303.52,RV-disorder-g,g,0,1,2,6,9
17,850,-1303.52,RV-O,O,73,15,88
17,850,-1303.52,RV-D,D,11,50,61
18,900,-1301.24,RV-order-a,a,11,1,1,2,15
18,900,-1301.24,RV-disorder-a,a,15,0,4,2,21
18,900,-1301.24,RV-order-t,t,5,31,3,4,43
18,900,-1301.24,RV-disorder-t,t,4,14,1,3,22
18,900,-1301.24,RV-order-c,c,1,5,17,2,25
18,900,-1301.24,RV-disorder-c,c,0,3,6,1,10
18,900,-1301.24,RV-order-g,g,0,1,0,6,7
18,900,-1301.24,RV-disorder-g,g,0,1,2,6,9
18,900,-1301.24,RV-O,O,73,15,88
18,900,-1301.24,RV-D,D,11,50,61
19,950,-1298.29,RV-order-a,a,11,1,1,2,15
19,950,-1298.29,RV-disorder-a,a,15,0,4,2,21
19,950,-1298.29,RV-order-t,t,5,31,3,4,43
19,950,-1298.29,RV-disorder-t,t,4,14,1,3,22
19,950,-1298.29,RV-order-c,c,1,5,17,2,25
19,950,-1298.29,RV-disorder-c,c,0,3,6,1,10
19,950,-1298.29,RV-order-g,g,0,1,0,6,7
19,950,-1298.29,RV-disorder-g,g,0,1,2,6,9
19,950,-1298.29,RV-O,O,73,15,88
19,950,-1298.29,RV-D,D,11,50,61
20,1000,-1296.63,RV-order-a,a,11,1,1,2,15
20,1000,-1296.63,RV-disorder-a,a,15,0,4,2,21
20,1000,-1296.63,RV-order-t,t,5,31,3,4,43
20,1000,-1296.63,RV-disorder-t,t,4,14,1,3,22
20,1000,-1296.63,RV-order-c,c,1,5,17,2,25
20,1000,-1296.63,RV-disorder-c,c,0,3,6,1,10
20,1000,-1296.63,RV-order-g,g,0,1,0,6,7
20,1000,-1296.63,RV-disorder-g,g,0,1,2,6,9
20,1000,-1296.63,RV-O,O,73,15,88
20,1000,-1296.63,RV-D,D,11,50,61
21,1050,-1290.25,RV-order-a,a,13,1,2,1,17
21,1050,-1290.25,RV-disorder-a,a,11,0,3,3,17
21,1050,-1290.25,RV-order-t,t,6,25,3,3,37
21,1050,-1290.25,RV-disorder-t,t,3,12,1,4,20
21,1050,-1290.25,RV-order-c,c,1,5,16,2,24
21,1050,-1290.25,RV-disorder-c,c,0,3,10,1,14
21,1050,-1290.25,RV-order-g,g,0,1,0,5,6
21,1050,-1290.25,RV-disorder-g,g,0,1,2,7,10
21,1050,-1290.25,RV-O,O,81,15,96
21,1050,-1290.25,RV-D,D,11,48,59
22,1100,-1287.3,RV-order-a,a,13,1,2,1,17
22,1100,-1287.3,RV-disorder-a,a,11,0,3,3,17
22,1100,-1287.3,RV-order-t,t,6,25,3,3,37
22,1100,-1287.3,RV-disorder-t,t,3,12,1,4,20
22,1100,-1287.3,RV-order-c,c,1,5,16,2,24
22,1100,-1287.3,RV-disorder-c,c,0,3,10,1,14
22,1100,-1287.3,RV-order-g,g,0,1,0,5,6
22,1100,-1287.3,RV-disorder-g,g,0,1,2,7,10
22,1100,-1287.3,RV-O,O,81,15,96
22,1100,-1287.3,RV-D,D,11,48,59
23,1150,-1285.8,RV-order-a,a,13,1,2,1,17
23,1150,-1285.8,RV-disorder-a,a,11,0,3,3,17
23,1150,-1285.8,RV-order-t,t,6,25,3,3,37
23,1150,-1285.8,RV-disorder-t,t,3,12,1,4,20
23,1150,-1285.8,RV-order-c,c,1,5,16,2,24
23,1150,-1285.8,RV-disorder-c,c,0,3,10,1,14
23,1150,-1285.8,RV-order-g,g,0,1,0,5,6
23,1150,-1285.8,RV-disorder-g,g,0,1,2,7,10
23,1150,-1285.8,RV-O,O,81,15,96
23,1150,-1285.8,RV-D,D,11,48,59
24,1200,-1281.74,RV-order-a,a,13,1,2,1,17
24,1200,-1281.74,RV-disorder-a,a,11,0,3,3,17
24,1200,-1281.74,RV-order-t,t,6,25,3,3,37
24,1200,-1281.74,RV-disorder-t,t,3,12,1,4,20
24,1200,-1281.74,RV-order-c,c,1,5,16,2,24
24,1200,-1281.74,RV-disorder-c,c,0,3,10,1,14
24,1200,-1281.74,RV-order-g,g,0,1,0,5,6
24,1200,-1281.74,RV-disorder-g,g,0,1,2,7,10
24,1200,-1281.74,RV-O,O,81,15,96
24,1200,-1281.74,RV-D,D,11,48,59
25,1250,-1281.75,RV-order-a,a,13,1,2,1,17
25,1250,-1281.75,RV-disorder-a,a,11,0,3,3,17
25,1250,-1281.75,RV-order-t,t,6,25,3,3,37
25,1250,-1281.75,RV-disorder-t,t,3,12,1,4,20
25,1250,-1281.75,RV-order-c,c,1,5,16,2,24
25,1250,-1281.75,RV-disorder-c,c,0,3,10,1,14
25,1250,-1281.75,RV-order-g,g,0,1,0,5,6
25,1250,-1281.75,RV-disorder-g,g,0,1,2,7,10
25,1250,-1281.75,RV-O,O,81,15,96
25,1250,-1281.75,RV-D,D,11,48,59
26,1300,-1302.33,RV-order-a,a,7,2,1,0,10
26,1300,-1302.33,RV-disorder-a,a,11,0,4,3,18
26,1300,-1302.33,RV-order-t,t,5,23,5,5,38
26,1300,-1302.33,RV-disorder-t,t,0,13,1,4,18
26,1300,-1302.33,RV-order-c,c,1,3,11,0,15
26,1300,-1302.33,RV-disorder-c,c,0,2,9,0,11
26,1300,-1302.33,RV-order-g,g,2,1,1,12,16
26,1300,-1302.33,RV-disorder-g,g,2,3,2,14,21
26,1300,-1302.33,RV-O,O,73,15,88
26,1300,-1302.33,RV-D,D,11,59,70
27,1350,-1299.12,RV-order-a,a,7,2,1,0,10
27,1350,-1299.12,RV-disorder-a,a,11,0,4,3,18
27,1350,-1299.12,RV-order-t,t,5,23,5,5,38
27,1350,-1299.12,RV-disorder-t,t,0,13,1,4,18
27,1350,-1299.12,RV-order-c,c,1,3,11,0,15
27,1350,-1299.12,RV-disorder-c,c,0,2,9,0,11
27,1350,-1299.12,RV-order-g,g,2,1,1,12,16
27,1350,-1299.12,RV-disorder-g,g,2,3,2,14,21
27,1350,-1299.12,RV-O,O,73,15,88
27,1350,-1299.12,RV-D,D,11,59,70
28,1400,-1299.86,RV-order-a,a,7,2,1,0,10
28,1400,-1299.86,RV-disorder-a,a,11,0,4,3,18
28,1400,-1299.86,RV-order-t,t,5,23,5,5,38
28,1400,-1299.86,RV-disorder-t,t,0,13,1,4,18
28,1400,-1299.86,RV-order-c,c,1,3,11,0,15
28,1400,-1299.86,RV-disorder-c,c,0,2,9,0,11
28,1400,-1299.86,RV-order-g,g,2,1,1,12,16
28,1400,-1299.86,RV-disorder-g,g,2,3,2,14,21
28,1400,-1299.86,RV-O,O,73,15,88
28,1400,-1299.86,RV-D,D,11,59,70
29,1450,-1298.66,RV-order-a,a,7,2,1,0,10
29,1450,-1298.66,RV-disorder-a,a,11,0,4,3,18
29,1450,-1298.66,RV-order-t,t,5,23,5,5,38
29,1450,-1298.66,RV-disorder-t,t,0,13,1,4,18
29,1450,-1298.66,RV-order-c,c,1,3,11,0,15
29,1450,-1298.66,RV-disorder-c,c,0,2,9,0,11
29,1450,-1298.66,RV-order-g,g,2,1,1,12,16
29,1450,-1298.66,RV-disorder-g,g,2,3,2,14,21
29,1450,-1298.66,RV-O,O,73,15,88
29,1450,-1298.66,RV-D,D,11,59,70
30,1500,-1297.74,RV-order-a,a,7,2,1,0,10
30,1500,-1297.74,RV-disorder-a,a,11,0,4,3,18
30,1500,-1297.74,RV-order-t,t,5,23,5,5,38
30,1500,-1297.74,RV-disorder-t,t,0,13,1,4,18
30,1500,-1297.74,RV-order-c,c,1,3,11,0,15
30,1500,-1297.74,RV-disorder-c,c,0,2,9,0,11
30,1500,-1297.74,RV-order-g,g,2,1,1,12,16
30,1500,-1297.74,RV-disorder-g,g,2,3,2,14,21
30,1500,-1297.74,RV-O,O,73,15,88
30,1500,-1297.74,RV-D,D,11,59,70
31,1550,-1260.5,RV-order-a,a,10,2,2,1,15
31,1550,-1260.5,RV-disorder-a,a,8,0,3,2,13
31,1550,-1260.5,RV-order-t,t,4,28,4,5,41
31,1550,-1260.5,RV-disorder-t,t,1,17,2,4,24
31,1550,-1260.5,RV-order-c,c,1,4,14,0,19
31,1550,-1260.5,RV-disorder-c,c,0,1,13,0,14
31,1550,-1260.5,RV-order-g,g,1,2,1,4,8
31,1550,-1260.5,RV-disorder-g,g,3,2,2,17,24
31,1550,-1260.5,RV-O,O,53,14,67
31,1550,-1260.5,RV-D,D,12,57,69
32,1600,-1260.55,RV-order-a,a,10,2,2,1,15
32,1600,-1260.55,RV-disorder-a,a,8,0,3,2,13
32,1600,-1260.55,RV-order-t,t,4,28,4,5,41
32,1600,-1260.55,RV-disorder-t,t,1,17,2,4,24
32,1600,-1260.55,RV-order-c,c,1,4,14,0,19
32,1600,-1260.55,RV-disorder-c,c,0,1,13,0,14
32,1600,-1260.55,RV-order-g,g,1,2,1,4,8
32,1600,-1260.55,RV-disorder-g,g,3,2,2,17,24
32,1600,-1260.55,RV-O,O,53,14,67
32,1600,-1260.55,RV-D,D,12,57,69
33,1650,-1260.66,RV-order-a,a,10,2,2,1,15
33,1650,-1260.66,RV-disorder-a,a,8,0,3,2,13
33,1650,-1260.66,RV-order-t,t,4,28,4,5,41
33,1650,-1260.66,RV-disorder-t,t,1,17,2,4,24
33,1650,-1260.66,RV-order-c,c,1,4,14,0,19
33,1650,-1260.66,RV-disorder-c,c,0,1,13,0,14
33,1650,-1260.66,RV-order-g,g,1,2,1,4,8
33,1650,-1260.66,RV-disorder-g,g,3,2,2,17,24
33,1650,-1260.66,RV-O,O,53,14,67
33,1650,-1260.66,RV-D,D,12,57,69
34,1700,-1262.45,RV-order-a,a,10,2,2,1,15
34,1700,-1262.45,RV-disorder-a,a,8,0,3,2,13
34,1700,-1262.45,RV-order-t,t,4,28,4,5,41
34,1700,-1262.45,RV-disorder-t,t,1,17,2,4,24
34,1700,-1262.45,RV-order-c,c,1,4,14,0,19
34,1700,-1262.45,RV-disorder-c,c,0,1,13,0,14
34,1700,-1262.45,RV-order-g,g,1,2,1,4,8
34,1700,-1262.45,RV-disorder-g,g,3,2,2,17,24
34,1700,-1262.45,RV-O,O,53,14,67
34,1700,-1262.45,RV-D,D,12,57,69
35,1750,-1259.72,RV-order-a,a,10,2,2,1,15
35,1750,-1259.72,RV-disorder-a,a,8,0,3,2,13
35,1750,-1259.72,RV-order-t,t,4,28,4,5,41
35,1750,-1259.72,RV-disorder-t,t,1,17,2,4,24
35,1750,-1259.72,RV-order-c,c,1,4,14,0,19
35,1750,-1259.72,RV-disorder-c,c,0,1,13,0,14
35,1750,-1259.72,RV-order-g,g,1,2,1,4,8
35,1750,-1259.72,RV-disorder-g,g,3,2,2,17,24
35,1750,-1259.72,RV-O,O,53,14,67
35,1750,-1259.72,RV-D,D,12,57,69
36,1800,-1262.54,RV-order-a,a,15,2,1,1,19
36,1800,-1262.54,RV-disorder-a,a,13,0,3,2,18
36,1800,-1262.54,RV-order-t,t,4,18,2,3,27
36,1800,-1262.54,RV-disorder-t,t,1,14,1,3,19
36,1800,-1262.54,RV-order-c,c,1,5,19,2,27
36,1800,-1262.54,RV-disorder-c,c,0,3,11,2,16
36,1800,-1262.54,RV-order-g,g,2,2,1,3,8
36,1800,-1262.54,RV-disorder-g,g,1,2,2,9,14
36,1800,-1262.54,RV-O,O,68,14,82
36,1800,-1262.54,RV-D,D,12,55,67
37,1850,-1263.22,RV-order-a,a,15,2,1,1,19
37,1850,-1263.22,RV-disorder-a,a,13,0,3,2,18
37,1850,-1263.22,RV-order-t,t,4,18,2,3,27
37,1850,-1263.22,RV-disorder-t,t,1,14,1,3,19
37,1850,-1263.22,RV-order-c,c,1,5,19,2,27
37,1850,-1263.22,RV-disorder-c,c,0,3,11,2,16
37,1850,-1263.22,RV-order-g,g,2,2,1,3,8
37,1850,-1263.22,RV-disorder-g,g,1,2,2,9,14
37,1850,-1263.22,RV-O,O,68,14,82
37,1850,-1263.22,RV-D,D,12,55,67
38,1900,-1261.65,RV-order-a,a,15,2,1,1,19
38,1900,-1261.65,RV-disorder-a,a,13,0,3,2,18
38,1900,-1261.65,RV-order-t,t,4,18,2,3,27
38,1900,-1261.65,RV-disorder-t,t,1,14,1,3,19
38,1900,-1261.65,RV-order-c,c,1,5,19,2,27
38,1900,-1261.65,RV-disorder-c,c,0,3,11,2,16
38,1900,-1261.65,RV-order-g,g,2,2,1,3,8
38,1900,-1261.65,RV-disorder-g,g,1,2,2,9,14
38,1900,-1261.65,RV-O,O,68,14,82
38,1900,-1261.65,RV-D,D,12,55,67
39,1950,-1260.45,RV-order-a,a,15,2,1,1,19
39,1950,-1260.45,RV-disorder-a,a,13,0,3,2,18
39,1950,-1260.45,RV-order-t,t,4,18,2,3,27
39,1950,-1260.45,RV-disorder-t,t,1,14,1,3,19
39,1950,-1260.45,RV-order-c,c,1,5,19,2,27
39,1950,-1260.45,RV-disorder-c,c,0,3,11,2,16
39,1950,-1260.45,RV-order-g,g,2,2,1,3,8
39,1950,-1260.45,RV-disorder-g,g,1,2,2,9,14
39,1950,-1260.45,RV-O,O,68,14,82
39,1950,-1260.45,RV-D,D,12,55,67
40,2000,-1257.45,RV-order-a,a,15,2,1,1,19
40,2000,-1257.45,RV-disorder-a,a,13,0,3,2,18
40,2000,-1257.45,RV-order-t,t,4,18,2,3,27
40,2000,-1257.45,RV-disorder-t,t,1,14,1,3,19
40,2000,-1257.45,RV-order-c,c,1,5,19,2,27
40,2000,-1257.45,RV-disorder-c,c,0,3,11,2,16
40,2000,-1257.45,RV-order-g,g,2,2,1,3,8
40,2000,-1257.45,RV-disorder-g,g,1,2,2,9,14
40,2000,-1257.45,RV-O,O,68,14,82
40,2000,-1257.45,RV-D,D,12,55,67
